modzcta,month,total_incidents,felonies,misdemeanors,violations,completed,attempted
10001,2020-01,506,167,289,50,495,11
10001,2020-02,482,167,276,39,475,7
10001,2020-03,333,104,193,36,330,3
10001,2020-04,196,84,88,24,190,6
10001,2020-05,222,77,121,24,218,4
10001,2020-06,339,149,145,45,335,4
10001,2020-07,360,118,191,51,354,6
10001,2020-08,372,132,201,39,365,7
10001,2020-09,414,144,226,44,407,7
10001,2020-10,460,183,232,45,448,12
10001,2020-11,362,133,185,44,356,6
10001,2020-12,423,133,239,51,413,10
10001,2021-01,384,135,200,49,376,8
10001,2021-02,359,117,198,44,349,10
10001,2021-03,421,156,214,51,411,10
10001,2021-04,386,128,208,50,376,10
10001,2021-05,466,150,265,51,454,12
10001,2021-06,478,176,257,45,467,11
10001,2021-07,526,198,265,63,514,12
10001,2021-08,469,177,237,55,459,10
10001,2021-09,550,200,299,51,536,14
10001,2021-10,581,231,285,65,566,15
10001,2021-11,581,207,311,63,564,17
10001,2021-12,627,243,339,45,610,17
10001,2022-01,483,170,262,51,470,13
10001,2022-02,566,214,293,59,550,16
10001,2022-03,615,225,331,59,603,12
10001,2022-04,582,214,313,55,566,16
10001,2022-05,622,255,309,58,615,7
10001,2022-06,650,279,301,70,641,9
10001,2022-07,648,270,311,67,640,8
10001,2022-08,583,250,280,53,574,9
10001,2022-09,607,277,261,69,592,15
10001,2022-10,656,253,325,78,632,24
10001,2022-11,642,253,324,65,631,11
10001,2022-12,682,262,369,51,669,13
10001,2023-01,644,245,330,69,633,11
10001,2023-02,573,217,296,60,562,11
10001,2023-03,599,243,304,52,591,8
10001,2023-04,634,223,348,63,623,11
10001,2023-05,664,259,356,49,659,5
10001,2023-06,685,251,381,53,680,5
10001,2023-07,690,226,399,65,686,4
10001,2023-08,647,220,377,50,639,8
10001,2023-09,570,203,306,61,560,10
10001,2023-10,590,210,326,54,585,5
10001,2023-11,582,219,302,61,578,4
10001,2023-12,631,247,327,57,624,7
10001,2024-01,639,226,355,58,632,7
10001,2024-02,595,233,316,46,589,6
10001,2024-03,656,215,367,74,647,9
10001,2024-04,697,242,405,50,686,11
10001,2024-05,745,253,430,62,737,8
10001,2024-06,656,217,388,51,648,8
10001,2024-07,624,212,376,36,618,6
10001,2024-08,646,219,368,59,640,6
10001,2024-09,607,210,341,56,601,6
10001,2024-10,633,216,347,70,625,8
10001,2024-11,704,249,395,60,692,12
10001,2024-12,594,187,356,51,594,0
10002,2020-01,452,126,250,76,444,8
10002,2020-02,370,97,210,63,367,3
10002,2020-03,368,123,185,60,360,8
10002,2020-04,305,78,179,48,296,9
10002,2020-05,366,105,209,52,361,5
10002,2020-06,403,127,227,49,395,8
10002,2020-07,506,146,273,87,494,12
10002,2020-08,406,134,202,70,397,9
10002,2020-09,407,132,203,72,396,11
10002,2020-10,403,124,235,44,397,6
10002,2020-11,396,131,225,40,392,4
10002,2020-12,421,144,217,60,409,12
10002,2021-01,380,107,222,51,375,5
10002,2021-02,346,94,203,49,341,5
10002,2021-03,447,137,240,70,437,6
10002,2021-04,438,127,239,72,430,3
10002,2021-05,504,148,287,69,499,5
10002,2021-06,512,161,287,64,504,8
10002,2021-07,564,154,330,80,559,5
10002,2021-08,548,146,332,70,544,4
10002,2021-09,601,152,369,80,595,6
10002,2021-10,785,210,476,99,777,8
10002,2021-11,626,197,347,82,621,5
10002,2021-12,672,186,395,91,661,11
10002,2022-01,587,155,358,74,582,5
10002,2022-02,612,154,390,68,604,8
10002,2022-03,788,225,444,119,778,10
10002,2022-04,648,192,374,82,636,12
10002,2022-05,714,184,430,100,707,7
10002,2022-06,735,212,433,90,730,5
10002,2022-07,649,221,349,79,647,2
10002,2022-08,704,241,386,77,695,9
10002,2022-09,649,216,348,85,637,12
10002,2022-10,584,178,320,86,579,5
10002,2022-11,501,143,273,85,496,5
10002,2022-12,518,162,277,79,511,7
10002,2023-01,510,172,273,65,502,8
10002,2023-02,393,139,189,65,391,2
10002,2023-03,529,162,288,79,522,7
10002,2023-04,562,191,285,86,555,7
10002,2023-05,582,180,322,80,577,5
10002,2023-06,572,204,304,64,570,2
10002,2023-07,568,219,272,77,562,6
10002,2023-08,587,182,304,101,580,7
10002,2023-09,543,210,242,91,537,6
10002,2023-10,596,201,299,96,591,5
10002,2023-11,482,175,236,71,469,13
10002,2023-12,495,157,255,83,489,6
10002,2024-01,535,147,252,136,529,6
10002,2024-02,437,150,201,86,433,4
10002,2024-03,518,174,273,71,510,8
10002,2024-04,533,182,266,85,523,10
10002,2024-05,530,184,270,76,525,5
10002,2024-06,554,187,292,75,551,3
10002,2024-07,560,191,288,81,552,8
10002,2024-08,523,202,258,63,513,10
10002,2024-09,567,175,301,91,558,9
10002,2024-10,577,172,320,85,565,12
10002,2024-11,537,145,296,96,530,7
10002,2024-12,450,139,225,86,447,3
10003,2020-01,397,122,244,31,391,6
10003,2020-02,409,110,246,53,406,3
10003,2020-03,344,102,196,46,339,5
10003,2020-04,195,65,107,23,191,4
10003,2020-05,308,131,164,13,299,9
10003,2020-06,311,158,130,23,303,8
10003,2020-07,272,95,151,26,266,6
10003,2020-08,289,113,152,24,282,7
10003,2020-09,337,129,175,33,325,12
10003,2020-10,378,142,198,38,374,4
10003,2020-11,308,107,179,22,299,9
10003,2020-12,295,95,180,20,288,7
10003,2021-01,247,73,152,22,246,1
10003,2021-02,225,83,112,30,219,5
10003,2021-03,298,80,190,28,294,4
10003,2021-04,299,99,172,28,287,11
10003,2021-05,358,126,201,31,354,4
10003,2021-06,398,126,238,34,395,3
10003,2021-07,322,103,184,35,315,7
10003,2021-08,372,135,195,42,367,5
10003,2021-09,420,156,239,25,413,7
10003,2021-10,475,184,240,51,464,11
10003,2021-11,478,194,241,43,469,9
10003,2021-12,399,158,201,40,394,5
10003,2022-01,353,124,204,25,341,12
10003,2022-02,367,125,216,26,361,6
10003,2022-03,463,153,269,41,452,11
10003,2022-04,464,154,270,40,447,17
10003,2022-05,502,167,288,47,494,8
10003,2022-06,555,203,313,39,552,3
10003,2022-07,549,188,320,41,546,3
10003,2022-08,457,155,264,38,450,7
10003,2022-09,460,177,246,37,452,8
10003,2022-10,475,163,273,39,469,6
10003,2022-11,386,131,211,44,382,4
10003,2022-12,357,127,193,37,351,6
10003,2023-01,368,124,201,43,363,5
10003,2023-02,331,121,177,33,326,5
10003,2023-03,402,159,205,38,390,12
10003,2023-04,408,158,213,37,403,5
10003,2023-05,383,131,210,42,374,9
10003,2023-06,527,183,306,38,526,1
10003,2023-07,443,147,267,29,439,4
10003,2023-08,519,205,275,39,511,8
10003,2023-09,385,158,198,29,384,1
10003,2023-10,430,155,238,37,428,2
10003,2023-11,434,148,253,33,430,4
10003,2023-12,464,153,259,52,463,1
10003,2024-01,458,172,245,41,452,6
10003,2024-02,355,87,232,36,349,6
10003,2024-03,424,115,276,33,421,3
10003,2024-04,456,127,285,44,448,8
10003,2024-05,483,153,286,44,478,5
10003,2024-06,497,145,307,45,493,4
10003,2024-07,559,160,357,42,556,3
10003,2024-08,586,171,380,35,585,1
10003,2024-09,536,157,322,57,530,6
10003,2024-10,490,153,298,39,479,11
10003,2024-11,506,161,309,36,503,3
10003,2024-12,369,109,223,37,365,4
10004,2020-01,54,18,27,9,54,0
10004,2020-02,36,9,19,8,36,0
10004,2020-03,27,7,12,8,27,0
10004,2020-04,12,6,3,3,12,0
10004,2020-05,11,6,4,1,11,0
10004,2020-06,19,3,14,2,19,0
10004,2020-07,23,6,12,5,22,1
10004,2020-08,38,10,26,2,38,0
10004,2020-09,29,6,14,9,29,0
10004,2020-10,26,7,15,4,26,0
10004,2020-11,27,5,20,2,27,0
10004,2020-12,25,12,10,3,25,0
10004,2021-01,20,6,11,3,20,0
10004,2021-02,26,10,12,4,26,0
10004,2021-03,45,10,26,9,44,1
10004,2021-04,29,6,19,4,29,0
10004,2021-05,29,10,14,5,29,0
10004,2021-06,36,9,23,4,34,2
10004,2021-07,38,6,26,6,35,3
10004,2021-08,30,12,13,5,30,0
10004,2021-09,22,7,11,4,22,0
10004,2021-10,39,6,25,8,39,0
10004,2021-11,32,10,17,5,32,0
10004,2021-12,36,12,20,4,35,1
10004,2022-01,29,11,12,6,29,0
10004,2022-02,22,6,12,4,22,0
10004,2022-03,44,10,26,8,44,0
10004,2022-04,45,12,29,4,45,0
10004,2022-05,45,14,25,6,45,0
10004,2022-06,34,11,13,10,34,0
10004,2022-07,37,12,17,8,36,1
10004,2022-08,34,13,20,1,33,1
10004,2022-09,37,18,13,6,36,1
10004,2022-10,33,8,17,8,33,0
10004,2022-11,34,13,16,5,33,1
10004,2022-12,48,15,29,4,48,0
10004,2023-01,32,7,17,8,32,0
10004,2023-02,33,8,21,4,33,0
10004,2023-03,60,15,36,9,59,1
10004,2023-04,38,7,26,5,38,0
10004,2023-05,65,15,40,10,64,1
10004,2023-06,50,11,29,10,50,0
10004,2023-07,41,15,24,2,41,0
10004,2023-08,50,10,33,7,50,0
10004,2023-09,36,14,13,9,36,0
10004,2023-10,43,10,24,9,43,0
10004,2023-11,71,9,53,9,71,0
10004,2023-12,51,15,29,7,51,0
10004,2024-01,64,13,48,3,64,0
10004,2024-02,55,17,31,7,55,0
10004,2024-03,72,19,47,6,72,0
10004,2024-04,68,16,39,13,68,0
10004,2024-05,74,17,46,11,74,0
10004,2024-06,65,9,41,15,65,0
10004,2024-07,93,25,57,11,92,1
10004,2024-08,54,17,30,7,54,0
10004,2024-09,63,16,38,9,63,0
10004,2024-10,58,15,36,7,57,1
10004,2024-11,48,9,35,4,48,0
10004,2024-12,45,6,35,4,45,0
10005,2020-01,37,8,27,2,37,0
10005,2020-02,36,12,22,2,36,0
10005,2020-03,30,7,17,6,30,0
10005,2020-04,16,3,10,3,16,0
10005,2020-05,22,6,15,1,20,2
10005,2020-06,27,10,15,2,26,1
10005,2020-07,28,10,15,3,27,1
10005,2020-08,40,11,26,3,40,0
10005,2020-09,42,7,32,3,42,0
10005,2020-10,39,14,20,5,39,0
10005,2020-11,20,4,10,6,20,0
10005,2020-12,25,8,14,3,23,2
10005,2021-01,23,7,14,2,23,0
10005,2021-02,38,14,20,4,36,2
10005,2021-03,25,7,15,3,25,0
10005,2021-04,27,4,20,3,27,0
10005,2021-05,31,2,22,7,31,0
10005,2021-06,31,5,17,9,31,0
10005,2021-07,36,11,18,7,36,0
10005,2021-08,41,9,22,10,41,0
10005,2021-09,45,8,27,10,44,1
10005,2021-10,68,13,46,9,68,0
10005,2021-11,57,16,36,5,56,1
10005,2021-12,59,11,42,6,58,1
10005,2022-01,61,18,31,12,61,0
10005,2022-02,83,24,55,4,83,0
10005,2022-03,83,21,52,10,83,0
10005,2022-04,142,22,112,8,141,1
10005,2022-05,121,23,93,5,120,1
10005,2022-06,114,21,88,5,113,1
10005,2022-07,145,26,113,6,143,2
10005,2022-08,95,12,79,4,95,0
10005,2022-09,112,13,91,8,111,1
10005,2022-10,79,17,59,3,79,0
10005,2022-11,115,12,96,7,115,0
10005,2022-12,108,10,94,4,108,0
10005,2023-01,62,10,45,7,62,0
10005,2023-02,49,19,23,7,49,0
10005,2023-03,43,17,17,9,43,0
10005,2023-04,63,14,44,5,63,0
10005,2023-05,69,16,48,5,69,0
10005,2023-06,48,13,30,5,48,0
10005,2023-07,65,16,44,5,65,0
10005,2023-08,73,16,51,6,73,0
10005,2023-09,51,18,26,7,51,0
10005,2023-10,54,14,38,2,54,0
10005,2023-11,30,16,13,1,30,0
10005,2023-12,36,14,19,3,36,0
10005,2024-01,39,10,22,7,39,0
10005,2024-02,37,10,22,5,37,0
10005,2024-03,61,35,22,4,59,2
10005,2024-04,38,13,19,6,38,0
10005,2024-05,36,12,20,4,36,0
10005,2024-06,39,9,23,7,39,0
10005,2024-07,39,13,23,3,39,0
10005,2024-08,43,10,24,9,43,0
10005,2024-09,36,11,20,5,36,0
10005,2024-10,53,13,31,9,52,1
10005,2024-11,39,11,22,6,39,0
10005,2024-12,33,12,17,4,33,0
10006,2020-01,56,19,35,2,55,1
10006,2020-02,35,11,20,4,35,0
10006,2020-03,19,7,10,2,19,0
10006,2020-04,8,2,6,0,8,0
10006,2020-05,9,3,5,1,9,0
10006,2020-06,10,2,7,1,10,0
10006,2020-07,23,4,16,3,22,1
10006,2020-08,14,4,10,0,14,0
10006,2020-09,37,6,25,6,36,1
10006,2020-10,38,3,35,0,38,0
10006,2020-11,46,7,38,1,45,1
10006,2020-12,37,6,26,5,37,0
10006,2021-01,52,5,40,7,52,0
10006,2021-02,24,7,16,1,24,0
10006,2021-03,26,3,23,0,23,3
10006,2021-04,41,6,28,7,41,0
10006,2021-05,27,4,21,2,26,1
10006,2021-06,32,11,17,4,30,2
10006,2021-07,26,7,17,2,26,0
10006,2021-08,44,7,33,4,44,0
10006,2021-09,59,17,39,3,58,1
10006,2021-10,51,10,38,3,51,0
10006,2021-11,42,13,27,2,41,1
10006,2021-12,47,13,30,4,46,1
10006,2022-01,39,8,28,3,39,0
10006,2022-02,55,16,38,1,55,0
10006,2022-03,52,8,41,3,52,0
10006,2022-04,44,10,32,2,44,0
10006,2022-05,56,12,39,5,55,1
10006,2022-06,53,11,37,5,53,0
10006,2022-07,57,18,37,2,57,0
10006,2022-08,53,10,42,1,53,0
10006,2022-09,63,16,43,4,63,0
10006,2022-10,72,17,51,4,72,0
10006,2022-11,70,18,45,7,69,1
10006,2022-12,76,17,54,5,74,2
10006,2023-01,59,14,42,3,59,0
10006,2023-02,43,9,31,3,42,1
10006,2023-03,65,18,44,3,65,0
10006,2023-04,39,10,24,5,38,1
10006,2023-05,47,13,30,4,47,0
10006,2023-06,52,16,32,4,52,0
10006,2023-07,46,10,34,2,46,0
10006,2023-08,75,18,52,5,75,0
10006,2023-09,71,19,50,2,71,0
10006,2023-10,80,10,62,8,79,1
10006,2023-11,74,16,56,2,74,0
10006,2023-12,59,12,45,2,59,0
10006,2024-01,76,17,59,0,76,0
10006,2024-02,56,7,49,0,55,1
10006,2024-03,83,15,65,3,81,2
10006,2024-04,53,13,40,0,52,1
10006,2024-05,71,23,42,6,70,1
10006,2024-06,51,13,33,5,50,1
10006,2024-07,59,21,32,6,58,1
10006,2024-08,54,8,44,2,54,0
10006,2024-09,52,19,31,2,52,0
10006,2024-10,63,16,43,4,63,0
10006,2024-11,59,16,36,7,59,0
10006,2024-12,37,9,22,6,37,0
10007,2020-01,120,35,77,8,119,1
10007,2020-02,129,30,76,23,125,4
10007,2020-03,63,18,39,6,63,0
10007,2020-04,48,10,36,2,47,1
10007,2020-05,46,17,27,2,46,0
10007,2020-06,72,21,45,6,72,0
10007,2020-07,99,29,62,8,97,2
10007,2020-08,84,22,57,5,81,3
10007,2020-09,81,15,63,3,81,0
10007,2020-10,118,23,89,6,118,0
10007,2020-11,107,20,81,6,104,3
10007,2020-12,100,27,62,11,98,2
10007,2021-01,95,21,66,8,93,2
10007,2021-02,114,23,83,8,112,2
10007,2021-03,109,28,75,6,108,1
10007,2021-04,107,19,80,8,102,1
10007,2021-05,133,13,109,11,129,4
10007,2021-06,137,20,110,7,136,1
10007,2021-07,124,29,90,5,123,1
10007,2021-08,115,29,80,6,113,2
10007,2021-09,190,39,143,8,189,1
10007,2021-10,162,27,128,7,160,2
10007,2021-11,151,27,117,7,151,0
10007,2021-12,149,30,111,8,148,1
10007,2022-01,179,27,140,12,179,0
10007,2022-02,182,29,144,9,181,1
10007,2022-03,174,33,132,9,173,1
10007,2022-04,168,27,136,5,166,2
10007,2022-05,221,32,178,11,220,1
10007,2022-06,188,32,146,10,187,1
10007,2022-07,169,35,123,11,167,2
10007,2022-08,165,26,131,8,165,0
10007,2022-09,137,25,100,12,136,1
10007,2022-10,137,33,89,15,137,0
10007,2022-11,167,32,125,10,164,3
10007,2022-12,137,25,102,10,135,2
10007,2023-01,157,24,128,5,157,0
10007,2023-02,136,15,109,12,135,1
10007,2023-03,137,33,94,10,135,2
10007,2023-04,116,19,84,13,116,0
10007,2023-05,182,39,129,14,182,0
10007,2023-06,177,46,121,10,175,2
10007,2023-07,196,43,140,13,196,0
10007,2023-08,214,30,176,8,213,1
10007,2023-09,189,37,142,10,188,1
10007,2023-10,214,44,154,16,213,1
10007,2023-11,187,38,138,11,185,2
10007,2023-12,176,33,129,14,175,1
10007,2024-01,183,33,129,21,183,0
10007,2024-02,131,27,95,9,129,2
10007,2024-03,141,33,99,9,138,3
10007,2024-04,174,32,128,14,174,0
10007,2024-05,164,38,114,12,164,0
10007,2024-06,167,41,112,14,167,0
10007,2024-07,142,38,92,12,141,1
10007,2024-08,145,27,108,10,144,1
10007,2024-09,165,32,123,10,165,0
10007,2024-10,131,26,95,10,129,2
10007,2024-11,135,28,98,9,135,0
10007,2024-12,152,24,106,22,152,0
10009,2020-01,257,81,133,43,250,7
10009,2020-02,271,77,150,44,265,6
10009,2020-03,215,65,105,45,212,3
10009,2020-04,191,59,94,38,189,2
10009,2020-05,199,63,103,33,198,1
10009,2020-06,238,81,111,46,236,2
10009,2020-07,224,73,110,41,221,3
10009,2020-08,263,88,135,40,262,1
10009,2020-09,258,81,133,44,253,5
10009,2020-10,244,100,106,38,238,6
10009,2020-11,250,88,119,43,243,7
10009,2020-12,220,75,108,37,217,3
10009,2021-01,224,74,121,29,220,4
10009,2021-02,211,72,108,31,207,4
10009,2021-03,261,94,135,32,255,5
10009,2021-04,252,89,128,35,246,4
10009,2021-05,310,102,164,44,305,5
10009,2021-06,350,91,201,58,345,5
10009,2021-07,380,127,207,46,375,5
10009,2021-08,349,114,177,58,345,4
10009,2021-09,343,123,179,41,339,4
10009,2021-10,411,128,222,61,406,5
10009,2021-11,362,101,216,45,359,3
10009,2021-12,358,117,200,41,353,5
10009,2022-01,328,104,183,41,324,4
10009,2022-02,325,113,175,37,321,4
10009,2022-03,417,130,244,43,412,5
10009,2022-04,372,98,225,49,369,3
10009,2022-05,361,117,190,54,357,4
10009,2022-06,394,127,205,62,391,3
10009,2022-07,378,131,195,52,375,3
10009,2022-08,378,126,197,55,370,8
10009,2022-09,386,121,223,42,382,4
10009,2022-10,343,117,177,49,341,2
10009,2022-11,356,120,186,50,348,8
10009,2022-12,292,101,154,37,291,1
10009,2023-01,304,89,161,54,298,6
10009,2023-02,288,84,165,39,285,3
10009,2023-03,341,98,176,67,336,5
10009,2023-04,311,110,156,45,309,2
10009,2023-05,319,127,144,48,318,1
10009,2023-06,340,113,178,49,340,0
10009,2023-07,305,112,152,41,303,2
10009,2023-08,294,105,149,40,290,4
10009,2023-09,290,101,152,37,289,1
10009,2023-10,315,86,176,53,313,2
10009,2023-11,265,86,141,38,262,3
10009,2023-12,286,86,163,37,282,4
10009,2024-01,282,83,148,51,281,1
10009,2024-02,237,69,127,41,232,5
10009,2024-03,268,83,140,45,265,3
10009,2024-04,259,88,129,42,255,4
10009,2024-05,309,87,166,56,303,6
10009,2024-06,276,79,149,48,275,1
10009,2024-07,302,97,159,46,299,3
10009,2024-08,287,86,154,47,285,2
10009,2024-09,289,77,156,56,287,2
10009,2024-10,371,101,192,78,366,5
10009,2024-11,321,91,172,58,313,8
10009,2024-12,220,69,118,33,214,6
10010,2020-01,172,69,77,26,170,2
10010,2020-02,175,54,95,26,174,1
10010,2020-03,130,41,70,19,128,2
10010,2020-04,72,26,35,11,69,3
10010,2020-05,98,39,49,10,95,3
10010,2020-06,117,56,46,15,112,5
10010,2020-07,144,56,77,11,142,2
10010,2020-08,160,62,79,19,154,6
10010,2020-09,157,51,92,14,154,3
10010,2020-10,189,61,102,26,187,2
10010,2020-11,130,53,59,18,128,2
10010,2020-12,136,52,67,17,134,2
10010,2021-01,120,38,66,16,115,5
10010,2021-02,97,33,55,9,94,3
10010,2021-03,127,49,58,20,123,4
10010,2021-04,120,34,67,19,117,3
10010,2021-05,142,48,78,16,140,2
10010,2021-06,123,41,67,15,121,2
10010,2021-07,166,53,92,21,162,4
10010,2021-08,146,48,76,22,146,0
10010,2021-09,145,49,77,19,140,5
10010,2021-10,158,55,83,20,156,2
10010,2021-11,129,45,69,15,128,1
10010,2021-12,137,46,79,12,135,2
10010,2022-01,144,55,75,14,140,4
10010,2022-02,154,49,94,11,151,3
10010,2022-03,154,50,85,19,152,2
10010,2022-04,158,63,85,10,158,0
10010,2022-05,162,50,88,24,160,2
10010,2022-06,187,71,95,21,182,5
10010,2022-07,199,58,112,29,197,2
10010,2022-08,182,58,98,26,179,3
10010,2022-09,170,62,82,26,166,4
10010,2022-10,200,66,112,22,199,1
10010,2022-11,135,45,68,22,131,4
10010,2022-12,146,48,84,14,140,6
10010,2023-01,159,52,87,20,156,3
10010,2023-02,144,50,75,19,143,1
10010,2023-03,162,51,86,25,160,2
10010,2023-04,161,49,96,16,160,1
10010,2023-05,197,49,126,22,193,4
10010,2023-06,171,51,94,26,169,2
10010,2023-07,184,50,120,14,182,2
10010,2023-08,190,52,126,12,185,5
10010,2023-09,191,69,104,18,187,4
10010,2023-10,194,68,113,13,192,2
10010,2023-11,181,47,111,23,178,3
10010,2023-12,182,58,110,14,182,0
10010,2024-01,218,54,144,20,217,1
10010,2024-02,197,33,150,14,194,3
10010,2024-03,193,43,138,12,192,1
10010,2024-04,178,33,127,18,176,2
10010,2024-05,201,56,126,19,198,3
10010,2024-06,202,63,118,21,201,1
10010,2024-07,175,54,101,20,174,1
10010,2024-08,221,74,126,21,218,3
10010,2024-09,189,53,106,30,185,4
10010,2024-10,239,52,162,25,236,3
10010,2024-11,271,73,182,16,270,1
10010,2024-12,186,59,114,13,185,1
10011,2020-01,360,142,181,37,350,10
10011,2020-02,334,110,187,37,321,13
10011,2020-03,281,98,164,19,267,14
10011,2020-04,157,52,78,27,148,9
10011,2020-05,248,100,127,21,240,8
10011,2020-06,289,125,139,25,285,4
10011,2020-07,284,107,145,32,278,6
10011,2020-08,335,103,184,48,330,5
10011,2020-09,332,130,167,35,320,12
10011,2020-10,344,134,175,35,341,3
10011,2020-11,281,106,153,22,271,10
10011,2020-12,227,96,112,19,222,5
10011,2021-01,267,93,153,21,263,4
10011,2021-02,214,68,122,24,209,5
10011,2021-03,248,85,136,27,244,4
10011,2021-04,262,69,160,33,258,4
10011,2021-05,247,94,115,38,246,1
10011,2021-06,335,125,174,36,330,5
10011,2021-07,314,116,158,40,309,5
10011,2021-08,353,119,197,37,347,6
10011,2021-09,404,161,192,51,396,8
10011,2021-10,434,138,250,46,421,13
10011,2021-11,381,143,209,29,374,7
10011,2021-12,305,105,167,33,300,5
10011,2022-01,275,107,140,28,272,3
10011,2022-02,313,117,157,39,310,3
10011,2022-03,331,121,169,41,326,5
10011,2022-04,375,130,196,49,369,6
10011,2022-05,432,158,232,42,421,11
10011,2022-06,426,159,211,56,423,3
10011,2022-07,405,154,223,28,400,5
10011,2022-08,373,153,169,51,366,7
10011,2022-09,402,138,214,50,398,4
10011,2022-10,408,182,184,42,399,9
10011,2022-11,327,126,160,41,322,5
10011,2022-12,322,118,167,37,319,3
10011,2023-01,336,112,185,39,331,5
10011,2023-02,302,120,155,27,296,6
10011,2023-03,345,121,184,40,340,5
10011,2023-04,371,140,192,39,363,8
10011,2023-05,353,138,178,37,344,9
10011,2023-06,388,142,208,38,386,2
10011,2023-07,359,127,201,31,353,6
10011,2023-08,424,134,236,54,419,5
10011,2023-09,322,113,187,22,320,2
10011,2023-10,371,153,182,36,366,5
10011,2023-11,360,110,211,39,354,6
10011,2023-12,310,111,159,40,307,3
10011,2024-01,321,108,171,42,315,6
10011,2024-02,345,98,209,38,341,4
10011,2024-03,348,111,192,45,346,2
10011,2024-04,306,82,187,37,296,10
10011,2024-05,371,116,196,59,366,5
10011,2024-06,306,106,165,35,304,2
10011,2024-07,341,137,150,54,340,1
10011,2024-08,328,116,172,40,323,5
10011,2024-09,360,109,202,49,355,5
10011,2024-10,393,135,208,50,388,5
10011,2024-11,322,98,196,28,320,2
10011,2024-12,293,99,165,29,290,3
10012,2020-01,248,84,145,19,247,1
10012,2020-02,248,97,131,20,244,4
10012,2020-03,153,55,79,19,149,4
10012,2020-04,83,30,48,5,82,1
10012,2020-05,163,79,75,9,160,3
10012,2020-06,246,110,124,12,244,2
10012,2020-07,157,51,88,18,155,2
10012,2020-08,178,81,84,13,176,2
10012,2020-09,172,70,87,15,168,4
10012,2020-10,198,69,113,16,194,4
10012,2020-11,160,75,78,7,159,1
10012,2020-12,132,61,64,7,130,2
10012,2021-01,162,70,80,12,159,3
10012,2021-02,121,51,59,11,117,4
10012,2021-03,152,64,72,16,146,6
10012,2021-04,164,56,87,21,161,3
10012,2021-05,183,76,97,10,176,7
10012,2021-06,202,72,110,20,199,3
10012,2021-07,183,79,94,10,180,3
10012,2021-08,179,68,99,12,176,3
10012,2021-09,192,87,89,16,190,2
10012,2021-10,271,124,132,15,266,5
10012,2021-11,245,129,104,12,242,3
10012,2021-12,206,82,104,20,204,2
10012,2022-01,231,94,121,16,228,3
10012,2022-02,207,77,110,20,203,4
10012,2022-03,225,96,105,24,218,7
10012,2022-04,276,102,149,25,272,4
10012,2022-05,286,129,133,24,284,2
10012,2022-06,266,119,124,23,266,0
10012,2022-07,263,111,136,16,263,0
10012,2022-08,283,120,142,21,282,1
10012,2022-09,316,124,181,11,312,4
10012,2022-10,340,123,189,28,336,4
10012,2022-11,305,110,166,29,301,4
10012,2022-12,281,127,142,12,279,2
10012,2023-01,324,124,176,24,322,2
10012,2023-02,255,106,131,18,253,2
10012,2023-03,258,90,153,15,256,2
10012,2023-04,278,116,140,22,276,2
10012,2023-05,337,120,195,22,335,2
10012,2023-06,308,105,187,16,307,1
10012,2023-07,253,95,140,18,251,2
10012,2023-08,318,105,194,19,317,1
10012,2023-09,291,102,176,13,289,2
10012,2023-10,334,126,195,13,333,1
10012,2023-11,322,122,174,26,320,2
10012,2023-12,372,118,237,17,367,5
10012,2024-01,316,92,208,16,313,3
10012,2024-02,324,84,213,27,324,0
10012,2024-03,336,103,214,19,334,2
10012,2024-04,299,72,214,13,297,2
10012,2024-05,348,107,217,24,347,1
10012,2024-06,334,135,184,15,330,4
10012,2024-07,379,107,254,18,379,0
10012,2024-08,433,140,274,19,430,3
10012,2024-09,497,135,337,25,495,2
10012,2024-10,442,129,289,24,438,4
10012,2024-11,369,109,241,19,369,0
10012,2024-12,328,91,227,10,324,4
10013,2020-01,237,91,119,27,236,1
10013,2020-02,252,96,131,25,248,4
10013,2020-03,167,73,81,13,163,4
10013,2020-04,93,41,42,10,92,1
10013,2020-05,179,73,96,10,177,2
10013,2020-06,204,89,97,18,200,4
10013,2020-07,184,58,104,22,181,3
10013,2020-08,241,76,138,27,237,4
10013,2020-09,189,82,86,21,187,2
10013,2020-10,223,82,120,21,223,0
10013,2020-11,177,71,91,15,175,1
10013,2020-12,153,50,91,12,149,4
10013,2021-01,179,73,90,16,177,2
10013,2021-02,120,54,55,11,115,4
10013,2021-03,201,67,101,33,199,1
10013,2021-04,188,63,101,24,181,7
10013,2021-05,198,53,125,20,197,1
10013,2021-06,240,83,121,36,237,3
10013,2021-07,188,56,110,22,187,1
10013,2021-08,229,71,141,17,227,2
10013,2021-09,223,75,128,20,221,2
10013,2021-10,254,104,126,24,247,7
10013,2021-11,256,111,120,25,250,6
10013,2021-12,260,111,139,10,258,2
10013,2022-01,224,81,123,20,223,1
10013,2022-02,260,99,131,30,253,7
10013,2022-03,267,90,144,33,264,3
10013,2022-04,225,88,119,18,223,2
10013,2022-05,261,94,143,24,258,3
10013,2022-06,256,96,134,26,254,2
10013,2022-07,310,132,156,22,306,4
10013,2022-08,265,99,143,23,262,3
10013,2022-09,256,93,140,23,254,2
10013,2022-10,299,124,155,20,297,2
10013,2022-11,301,106,178,17,299,2
10013,2022-12,241,90,128,23,240,1
10013,2023-01,249,109,120,20,246,3
10013,2023-02,221,96,99,26,219,2
10013,2023-03,232,90,124,18,229,3
10013,2023-04,234,81,132,21,233,1
10013,2023-05,232,91,115,26,229,3
10013,2023-06,265,97,133,35,264,1
10013,2023-07,259,104,133,22,255,4
10013,2023-08,286,105,158,23,280,6
10013,2023-09,278,121,131,26,277,1
10013,2023-10,290,95,170,25,286,4
10013,2023-11,256,98,133,25,253,3
10013,2023-12,221,77,133,11,221,0
10013,2024-01,267,110,118,39,261,6
10013,2024-02,233,85,125,23,228,5
10013,2024-03,254,102,139,13,252,2
10013,2024-04,259,87,150,22,257,2
10013,2024-05,332,143,165,24,329,3
10013,2024-06,314,121,169,24,310,4
10013,2024-07,341,136,178,27,340,1
10013,2024-08,334,132,181,21,331,3
10013,2024-09,347,132,188,27,342,5
10013,2024-10,328,143,153,32,324,4
10013,2024-11,282,110,144,28,277,5
10013,2024-12,226,110,95,21,223,3
10014,2020-01,245,103,121,21,240,5
10014,2020-02,240,85,127,28,234,6
10014,2020-03,213,75,106,32,204,9
10014,2020-04,95,35,56,4,91,4
10014,2020-05,162,63,83,16,157,5
10014,2020-06,159,77,68,14,155,4
10014,2020-07,163,56,87,20,154,9
10014,2020-08,160,67,78,15,152,8
10014,2020-09,220,83,115,22,212,8
10014,2020-10,185,73,96,16,182,3
10014,2020-11,177,73,88,16,169,8
10014,2020-12,153,62,77,14,147,6
10014,2021-01,140,51,76,13,137,3
10014,2021-02,116,47,59,10,113,3
10014,2021-03,125,48,67,10,122,3
10014,2021-04,141,53,74,14,139,2
10014,2021-05,202,78,105,19,199,3
10014,2021-06,206,77,107,22,202,4
10014,2021-07,217,72,122,23,212,5
10014,2021-08,219,76,126,17,218,1
10014,2021-09,241,113,95,33,234,7
10014,2021-10,258,106,122,30,252,6
10014,2021-11,219,93,104,22,214,5
10014,2021-12,191,81,93,17,185,6
10014,2022-01,184,82,87,15,179,5
10014,2022-02,198,80,94,24,195,3
10014,2022-03,287,117,139,31,282,5
10014,2022-04,282,109,146,27,279,3
10014,2022-05,275,114,138,23,270,5
10014,2022-06,360,153,175,32,352,8
10014,2022-07,293,134,132,27,287,6
10014,2022-08,334,135,171,28,326,8
10014,2022-09,312,136,152,24,305,7
10014,2022-10,303,117,163,23,299,4
10014,2022-11,282,115,139,28,278,4
10014,2022-12,247,94,130,23,242,5
10014,2023-01,287,103,156,28,284,3
10014,2023-02,246,97,125,24,242,4
10014,2023-03,236,87,130,19,231,5
10014,2023-04,262,89,148,25,258,4
10014,2023-05,219,83,114,22,215,4
10014,2023-06,285,121,151,13,281,4
10014,2023-07,291,116,157,18,285,6
10014,2023-08,280,97,165,18,278,2
10014,2023-09,268,113,134,21,265,3
10014,2023-10,278,105,158,15,272,6
10014,2023-11,247,89,141,17,244,3
10014,2023-12,247,92,134,21,242,5
10014,2024-01,226,68,135,23,225,1
10014,2024-02,263,90,152,21,259,4
10014,2024-03,261,87,150,24,255,6
10014,2024-04,274,82,167,25,269,5
10014,2024-05,293,114,148,31,288,5
10014,2024-06,298,113,162,23,294,4
10014,2024-07,293,112,159,22,288,5
10014,2024-08,315,109,182,24,314,1
10014,2024-09,299,110,161,28,290,9
10014,2024-10,313,125,175,13,305,8
10014,2024-11,321,99,212,10,320,1
10014,2024-12,262,79,173,10,261,1
10016,2020-01,220,71,116,33,219,1
10016,2020-02,219,78,105,36,216,3
10016,2020-03,201,65,96,40,196,5
10016,2020-04,124,41,65,18,121,3
10016,2020-05,181,65,95,21,179,2
10016,2020-06,217,91,98,28,212,5
10016,2020-07,313,82,204,27,308,5
10016,2020-08,264,101,127,36,256,8
10016,2020-09,208,65,102,41,203,5
10016,2020-10,266,69,164,33,261,5
10016,2020-11,219,94,98,27,214,5
10016,2020-12,225,95,100,30,221,4
10016,2021-01,237,72,130,35,231,6
10016,2021-02,207,66,109,32,206,1
10016,2021-03,244,76,129,39,237,7
10016,2021-04,211,77,98,36,209,2
10016,2021-05,201,66,100,35,196,5
10016,2021-06,233,76,124,33,230,3
10016,2021-07,269,98,134,37,264,5
10016,2021-08,292,105,141,46,284,8
10016,2021-09,294,110,150,34,283,11
10016,2021-10,330,106,172,52,323,7
10016,2021-11,246,95,122,29,240,6
10016,2021-12,246,103,116,27,239,7
10016,2022-01,232,82,120,30,224,8
10016,2022-02,247,80,136,31,244,3
10016,2022-03,289,112,138,39,275,14
10016,2022-04,269,86,153,30,263,6
10016,2022-05,341,127,184,30,334,7
10016,2022-06,323,126,143,54,318,5
10016,2022-07,310,104,167,39,301,9
10016,2022-08,339,123,172,44,333,6
10016,2022-09,265,101,134,30,258,7
10016,2022-10,309,122,148,39,304,5
10016,2022-11,288,102,144,42,280,8
10016,2022-12,286,115,137,34,283,3
10016,2023-01,263,102,117,44,254,9
10016,2023-02,245,102,112,31,242,3
10016,2023-03,287,102,142,43,284,3
10016,2023-04,279,100,126,53,275,4
10016,2023-05,334,112,183,39,327,7
10016,2023-06,287,98,147,42,284,3
10016,2023-07,305,102,154,49,298,7
10016,2023-08,251,94,128,29,248,3
10016,2023-09,258,98,132,28,254,4
10016,2023-10,279,86,146,47,276,3
10016,2023-11,289,87,169,33,287,2
10016,2023-12,268,97,135,36,267,1
10016,2024-01,287,85,177,25,284,3
10016,2024-02,258,70,156,32,256,2
10016,2024-03,240,74,142,24,239,1
10016,2024-04,243,97,116,30,240,3
10016,2024-05,291,92,167,32,284,7
10016,2024-06,234,67,137,30,231,3
10016,2024-07,254,85,135,34,253,1
10016,2024-08,259,96,125,38,256,3
10016,2024-09,290,83,168,39,286,4
10016,2024-10,278,75,166,37,273,5
10016,2024-11,274,83,162,29,272,2
10016,2024-12,223,53,136,34,222,1
10017,2020-01,183,48,116,19,181,2
10017,2020-02,153,46,97,10,148,5
10017,2020-03,164,48,99,17,159,5
10017,2020-04,47,13,27,7,47,0
10017,2020-05,101,22,64,15,99,2
10017,2020-06,113,39,68,6,111,2
10017,2020-07,188,51,121,16,183,5
10017,2020-08,195,44,134,17,194,1
10017,2020-09,171,33,126,12,167,4
10017,2020-10,220,47,159,14,216,4
10017,2020-11,171,39,115,17,165,6
10017,2020-12,156,49,89,18,153,3
10017,2021-01,121,38,67,16,117,4
10017,2021-02,121,33,73,15,117,4
10017,2021-03,181,62,103,16,175,6
10017,2021-04,156,39,89,28,154,2
10017,2021-05,163,45,103,15,159,4
10017,2021-06,132,36,81,15,132,0
10017,2021-07,176,44,106,26,175,1
10017,2021-08,160,40,103,17,159,1
10017,2021-09,146,44,73,29,142,4
10017,2021-10,208,70,104,34,201,7
10017,2021-11,161,54,84,23,156,5
10017,2021-12,171,62,79,30,170,1
10017,2022-01,167,66,81,20,163,4
10017,2022-02,193,45,127,21,191,2
10017,2022-03,228,71,133,24,226,2
10017,2022-04,222,59,144,19,219,3
10017,2022-05,224,62,139,23,219,5
10017,2022-06,218,74,125,19,217,1
10017,2022-07,241,67,154,20,239,2
10017,2022-08,253,63,153,37,250,3
10017,2022-09,232,76,134,22,229,3
10017,2022-10,229,73,116,40,225,4
10017,2022-11,174,73,77,24,169,5
10017,2022-12,180,66,96,18,179,1
10017,2023-01,225,73,121,31,219,6
10017,2023-02,162,51,89,22,162,0
10017,2023-03,179,81,79,19,176,3
10017,2023-04,177,65,86,26,175,2
10017,2023-05,217,53,144,20,214,3
10017,2023-06,226,61,128,37,224,2
10017,2023-07,231,67,137,27,227,4
10017,2023-08,252,77,146,29,249,3
10017,2023-09,222,72,119,31,219,3
10017,2023-10,229,61,142,26,228,1
10017,2023-11,202,61,114,27,200,2
10017,2023-12,230,90,120,20,226,4
10017,2024-01,260,99,134,27,256,4
10017,2024-02,215,65,134,16,207,8
10017,2024-03,258,80,155,23,254,4
10017,2024-04,245,65,154,26,242,3
10017,2024-05,243,77,143,23,240,3
10017,2024-06,215,70,126,19,211,4
10017,2024-07,223,89,114,20,222,1
10017,2024-08,212,77,118,17,212,0
10017,2024-09,166,69,85,12,162,4
10017,2024-10,228,56,146,26,226,2
10017,2024-11,206,63,123,20,203,3
10017,2024-12,192,69,109,14,189,3
10018,2020-01,177,74,86,17,174,3
10018,2020-02,193,66,113,14,191,2
10018,2020-03,135,54,69,12,132,3
10018,2020-04,84,43,35,6,81,3
10018,2020-05,116,54,51,11,111,5
10018,2020-06,173,91,67,15,167,6
10018,2020-07,164,66,73,25,163,1
10018,2020-08,185,58,109,18,181,4
10018,2020-09,191,88,86,17,186,5
10018,2020-10,241,110,106,25,237,4
10018,2020-11,181,81,83,17,177,4
10018,2020-12,193,70,106,17,192,1
10018,2021-01,221,78,110,33,215,6
10018,2021-02,192,68,101,23,186,6
10018,2021-03,260,90,134,36,250,10
10018,2021-04,233,86,112,35,224,9
10018,2021-05,255,95,130,30,249,6
10018,2021-06,248,106,125,17,244,4
10018,2021-07,251,98,134,19,239,12
10018,2021-08,248,96,131,21,242,6
10018,2021-09,281,113,143,25,268,13
10018,2021-10,270,122,129,19,257,13
10018,2021-11,259,105,135,19,253,6
10018,2021-12,232,109,109,14,226,6
10018,2022-01,205,95,91,19,192,13
10018,2022-02,238,94,126,18,229,9
10018,2022-03,239,92,125,22,233,6
10018,2022-04,290,123,138,29,280,10
10018,2022-05,294,131,145,18,286,8
10018,2022-06,317,149,136,32,305,12
10018,2022-07,324,130,167,27,315,9
10018,2022-08,333,129,184,20,326,7
10018,2022-09,311,132,154,25,304,7
10018,2022-10,297,138,137,22,287,10
10018,2022-11,322,157,147,18,308,14
10018,2022-12,288,120,145,23,279,9
10018,2023-01,244,108,115,21,237,7
10018,2023-02,254,99,129,26,249,5
10018,2023-03,267,110,137,20,259,8
10018,2023-04,294,121,156,17,288,6
10018,2023-05,269,127,120,22,264,5
10018,2023-06,285,109,154,22,281,4
10018,2023-07,303,139,142,22,298,5
10018,2023-08,346,166,157,23,338,8
10018,2023-09,290,132,132,26,284,6
10018,2023-10,289,129,131,29,282,7
10018,2023-11,287,133,135,19,282,5
10018,2023-12,282,124,136,22,279,3
10018,2024-01,273,109,141,23,269,4
10018,2024-02,291,127,145,19,285,6
10018,2024-03,409,136,139,134,403,6
10018,2024-04,275,125,135,15,266,9
10018,2024-05,308,129,161,18,305,3
10018,2024-06,346,129,193,24,342,4
10018,2024-07,373,148,195,30,366,7
10018,2024-08,363,165,178,20,358,5
10018,2024-09,324,132,173,19,318,6
10018,2024-10,374,151,207,16,366,8
10018,2024-11,344,145,163,36,340,4
10018,2024-12,263,99,140,24,261,2
10019,2020-01,410,150,198,62,404,6
10019,2020-02,358,115,203,40,352,6
10019,2020-03,271,83,142,46,268,3
10019,2020-04,125,42,53,30,122,3
10019,2020-05,144,51,73,20,139,5
10019,2020-06,285,97,154,34,281,4
10019,2020-07,300,93,158,49,289,11
10019,2020-08,255,91,125,39,252,3
10019,2020-09,245,93,108,44,243,2
10019,2020-10,332,115,177,40,329,3
10019,2020-11,277,87,152,38,274,3
10019,2020-12,289,116,131,42,286,3
10019,2021-01,246,76,135,35,245,1
10019,2021-02,233,64,129,40,230,3
10019,2021-03,305,81,165,59,301,4
10019,2021-04,265,82,126,57,259,6
10019,2021-05,306,91,159,56,303,3
10019,2021-06,296,94,149,53,295,1
10019,2021-07,341,115,189,37,335,6
10019,2021-08,323,108,151,64,318,5
10019,2021-09,356,102,184,70,351,5
10019,2021-10,410,121,229,60,408,2
10019,2021-11,342,118,178,46,337,5
10019,2021-12,362,136,171,55,356,6
10019,2022-01,266,91,135,40,262,4
10019,2022-02,365,96,217,52,358,7
10019,2022-03,404,131,219,54,398,6
10019,2022-04,381,148,190,43,379,2
10019,2022-05,483,144,267,72,478,5
10019,2022-06,480,129,281,70,474,6
10019,2022-07,470,148,265,57,465,5
10019,2022-08,441,137,249,55,440,1
10019,2022-09,449,136,247,66,446,3
10019,2022-10,481,151,272,58,479,2
10019,2022-11,426,135,235,56,423,3
10019,2022-12,399,160,182,57,396,3
10019,2023-01,323,104,183,36,321,2
10019,2023-02,273,75,160,38,272,1
10019,2023-03,385,129,205,51,378,7
10019,2023-04,417,125,239,53,415,2
10019,2023-05,415,130,230,55,410,5
10019,2023-06,430,132,236,62,426,4
10019,2023-07,389,131,215,43,386,3
10019,2023-08,424,138,225,61,421,3
10019,2023-09,445,122,258,65,439,6
10019,2023-10,463,139,265,59,458,5
10019,2023-11,406,131,226,49,403,3
10019,2023-12,468,194,222,52,464,4
10019,2024-01,483,164,266,53,478,5
10019,2024-02,400,121,232,47,398,2
10019,2024-03,487,163,256,68,483,4
10019,2024-04,481,166,265,50,477,4
10019,2024-05,577,180,333,64,575,2
10019,2024-06,500,164,277,59,494,6
10019,2024-07,567,184,324,59,562,5
10019,2024-08,632,185,375,72,626,6
10019,2024-09,534,165,311,58,527,7
10019,2024-10,504,149,301,54,502,2
10019,2024-11,530,171,309,50,528,2
10019,2024-12,561,223,275,63,551,10
10021,2020-01,120,43,66,11,114,6
10021,2020-02,130,35,84,11,128,2
10021,2020-03,107,27,67,13,105,2
10021,2020-04,72,25,43,4,71,1
10021,2020-05,69,15,46,8,66,3
10021,2020-06,70,24,42,4,68,2
10021,2020-07,101,31,62,8,99,2
10021,2020-08,125,43,69,13,123,2
10021,2020-09,119,50,59,10,116,3
10021,2020-10,108,50,47,11,102,6
10021,2020-11,96,42,42,12,96,0
10021,2020-12,87,29,48,10,87,0
10021,2021-01,84,36,42,6,83,1
10021,2021-02,55,19,33,3,54,1
10021,2021-03,91,26,51,14,88,3
10021,2021-04,98,42,44,12,98,0
10021,2021-05,104,27,69,8,103,1
10021,2021-06,102,38,51,13,96,6
10021,2021-07,90,29,54,7,86,4
10021,2021-08,86,38,37,11,86,0
10021,2021-09,131,51,69,11,125,6
10021,2021-10,105,34,60,11,102,3
10021,2021-11,99,45,47,7,98,1
10021,2021-12,114,39,57,18,113,1
10021,2022-01,121,35,76,10,121,0
10021,2022-02,120,31,73,16,117,3
10021,2022-03,196,46,131,19,194,2
10021,2022-04,151,44,94,13,147,4
10021,2022-05,123,37,76,10,122,1
10021,2022-06,207,54,133,20,203,4
10021,2022-07,138,54,67,17,135,3
10021,2022-08,155,42,99,14,154,1
10021,2022-09,191,54,122,15,190,1
10021,2022-10,181,43,127,11,179,2
10021,2022-11,181,48,112,21,181,0
10021,2022-12,126,34,83,9,126,0
10021,2023-01,143,39,91,13,142,1
10021,2023-02,143,46,86,11,139,4
10021,2023-03,129,40,74,15,129,0
10021,2023-04,125,42,70,13,123,2
10021,2023-05,148,42,90,16,148,0
10021,2023-06,154,38,106,10,154,0
10021,2023-07,160,51,101,8,160,0
10021,2023-08,127,47,73,7,127,0
10021,2023-09,121,38,67,16,120,1
10021,2023-10,135,50,76,9,133,2
10021,2023-11,100,38,50,12,100,0
10021,2023-12,115,36,63,16,113,2
10021,2024-01,137,56,74,7,135,2
10021,2024-02,106,39,57,10,104,2
10021,2024-03,129,38,79,12,124,5
10021,2024-04,111,25,68,18,110,1
10021,2024-05,146,55,75,16,146,0
10021,2024-06,160,40,112,8,160,0
10021,2024-07,163,33,122,8,162,1
10021,2024-08,247,47,189,11,244,3
10021,2024-09,199,46,143,10,197,2
10021,2024-10,180,47,117,16,177,3
10021,2024-11,151,40,103,8,149,2
10021,2024-12,138,28,102,8,138,0
10022,2020-01,271,121,123,27,263,8
10022,2020-02,247,113,108,26,238,9
10022,2020-03,158,85,58,15,153,5
10022,2020-04,80,25,48,7,79,1
10022,2020-05,89,28,48,13,87,2
10022,2020-06,144,65,69,10,134,10
10022,2020-07,155,69,70,16,151,4
10022,2020-08,164,65,87,12,160,4
10022,2020-09,205,96,93,16,200,5
10022,2020-10,242,112,114,16,237,5
10022,2020-11,198,88,92,18,191,7
10022,2020-12,183,83,83,17,181,2
10022,2021-01,171,76,83,12,168,3
10022,2021-02,156,65,79,12,152,4
10022,2021-03,193,84,93,16,187,6
10022,2021-04,155,52,83,20,150,5
10022,2021-05,184,72,89,23,178,6
10022,2021-06,197,84,95,18,192,5
10022,2021-07,184,71,96,17,180,4
10022,2021-08,208,91,102,15,207,1
10022,2021-09,185,71,97,17,185,0
10022,2021-10,245,116,110,19,241,4
10022,2021-11,284,151,107,26,280,4
10022,2021-12,303,149,126,28,296,7
10022,2022-01,231,99,108,24,231,0
10022,2022-02,231,109,99,23,228,3
10022,2022-03,252,105,117,30,249,3
10022,2022-04,200,95,79,26,197,3
10022,2022-05,263,120,109,34,257,6
10022,2022-06,240,103,114,23,236,4
10022,2022-07,310,158,138,14,304,6
10022,2022-08,317,126,166,25,313,4
10022,2022-09,286,136,122,28,279,7
10022,2022-10,321,158,133,30,319,2
10022,2022-11,277,131,124,22,270,7
10022,2022-12,274,147,105,22,273,1
10022,2023-01,230,115,90,25,226,4
10022,2023-02,207,93,93,21,205,2
10022,2023-03,240,100,107,33,236,4
10022,2023-04,224,99,106,19,219,5
10022,2023-05,304,135,146,23,302,2
10022,2023-06,263,100,134,29,260,3
10022,2023-07,264,91,154,19,261,3
10022,2023-08,269,131,119,19,267,2
10022,2023-09,254,105,127,22,251,3
10022,2023-10,270,114,145,11,264,6
10022,2023-11,282,142,113,27,281,1
10022,2023-12,336,172,138,26,333,3
10022,2024-01,253,100,132,21,246,7
10022,2024-02,191,74,97,20,188,3
10022,2024-03,239,103,113,23,237,2
10022,2024-04,219,95,107,17,217,2
10022,2024-05,224,90,108,26,221,3
10022,2024-06,234,79,134,21,232,2
10022,2024-07,234,110,107,17,231,3
10022,2024-08,230,98,119,13,227,3
10022,2024-09,241,91,139,11,237,4
10022,2024-10,260,104,131,25,256,4
10022,2024-11,251,104,123,24,250,1
10022,2024-12,223,80,126,17,223,0
10023,2020-01,193,48,127,18,189,4
10023,2020-02,214,60,132,22,211,3
10023,2020-03,148,38,73,37,147,1
10023,2020-04,90,31,42,17,88,2
10023,2020-05,112,23,76,13,110,2
10023,2020-06,142,51,74,17,138,4
10023,2020-07,197,59,117,21,196,1
10023,2020-08,246,69,155,22,245,1
10023,2020-09,231,64,150,17,229,2
10023,2020-10,210,40,154,16,209,1
10023,2020-11,228,48,160,20,227,1
10023,2020-12,241,53,174,14,238,3
10023,2021-01,202,41,152,9,200,2
10023,2021-02,204,45,151,8,204,0
10023,2021-03,233,53,159,21,227,1
10023,2021-04,203,60,128,15,175,6
10023,2021-05,199,63,109,27,196,3
10023,2021-06,209,54,135,20,206,3
10023,2021-07,192,45,120,27,188,4
10023,2021-08,189,52,108,29,189,0
10023,2021-09,191,61,104,26,190,1
10023,2021-10,221,90,114,17,219,2
10023,2021-11,215,74,107,34,213,2
10023,2021-12,176,71,86,19,175,1
10023,2022-01,188,59,104,25,183,5
10023,2022-02,224,67,131,26,221,3
10023,2022-03,220,62,126,32,218,2
10023,2022-04,251,71,156,24,243,8
10023,2022-05,248,74,145,29,246,2
10023,2022-06,244,98,108,38,240,4
10023,2022-07,222,90,106,26,219,3
10023,2022-08,209,89,105,15,208,1
10023,2022-09,227,88,112,27,223,4
10023,2022-10,183,71,85,27,174,9
10023,2022-11,194,75,85,34,193,1
10023,2022-12,155,51,80,24,152,3
10023,2023-01,155,58,79,18,153,2
10023,2023-02,190,68,97,25,189,1
10023,2023-03,205,69,108,28,205,0
10023,2023-04,204,71,103,30,202,2
10023,2023-05,207,89,94,24,205,2
10023,2023-06,187,63,105,19,183,4
10023,2023-07,218,80,112,26,211,7
10023,2023-08,199,76,98,25,196,3
10023,2023-09,197,63,111,23,193,4
10023,2023-10,216,74,120,22,210,6
10023,2023-11,227,90,112,25,224,3
10023,2023-12,218,83,102,33,214,4
10023,2024-01,187,59,109,19,186,1
10023,2024-02,182,61,97,24,180,2
10023,2024-03,159,62,76,21,157,2
10023,2024-04,211,70,122,19,210,1
10023,2024-05,219,69,124,26,217,2
10023,2024-06,230,74,137,19,229,1
10023,2024-07,232,69,142,21,228,4
10023,2024-08,198,59,117,22,198,0
10023,2024-09,259,87,147,25,254,5
10023,2024-10,246,90,138,18,244,2
10023,2024-11,239,70,136,33,239,0
10023,2024-12,170,52,105,13,169,1
10024,2020-01,212,74,117,21,207,5
10024,2020-02,152,36,100,16,151,1
10024,2020-03,117,31,64,22,116,1
10024,2020-04,103,31,46,26,100,3
10024,2020-05,122,32,83,7,119,3
10024,2020-06,140,41,82,17,137,3
10024,2020-07,205,53,113,39,204,1
10024,2020-08,209,54,131,24,205,4
10024,2020-09,207,63,125,19,206,1
10024,2020-10,172,64,86,22,169,3
10024,2020-11,146,50,81,15,144,2
10024,2020-12,139,54,73,12,135,4
10024,2021-01,155,42,95,18,153,2
10024,2021-02,112,43,50,19,111,1
10024,2021-03,157,57,78,22,155,1
10024,2021-04,172,56,91,25,163,8
10024,2021-05,156,56,83,17,151,5
10024,2021-06,138,50,62,26,135,3
10024,2021-07,166,71,71,24,162,4
10024,2021-08,162,71,76,15,157,5
10024,2021-09,189,87,79,23,187,2
10024,2021-10,209,84,97,28,208,1
10024,2021-11,178,78,79,21,177,1
10024,2021-12,153,53,84,16,152,1
10024,2022-01,160,54,80,26,159,1
10024,2022-02,174,73,79,22,169,5
10024,2022-03,187,62,102,23,186,1
10024,2022-04,194,83,88,23,188,6
10024,2022-05,245,59,146,40,244,1
10024,2022-06,225,93,111,21,219,6
10024,2022-07,200,72,101,27,193,7
10024,2022-08,198,87,92,19,196,2
10024,2022-09,181,78,76,27,179,2
10024,2022-10,155,71,65,19,154,1
10024,2022-11,158,78,64,16,153,5
10024,2022-12,157,54,85,18,156,1
10024,2023-01,172,60,94,18,165,7
10024,2023-02,126,51,60,15,124,2
10024,2023-03,136,66,57,13,131,5
10024,2023-04,166,73,64,29,164,2
10024,2023-05,186,56,105,25,184,2
10024,2023-06,183,81,81,21,181,2
10024,2023-07,176,62,95,19,175,1
10024,2023-08,214,82,105,27,212,2
10024,2023-09,194,56,101,37,190,4
10024,2023-10,186,74,91,21,180,6
10024,2023-11,177,67,87,23,171,6
10024,2023-12,131,63,55,13,131,0
10024,2024-01,167,66,81,20,165,2
10024,2024-02,142,60,58,24,140,2
10024,2024-03,159,52,81,26,157,2
10024,2024-04,157,56,81,20,154,3
10024,2024-05,163,65,75,23,161,2
10024,2024-06,172,72,71,29,166,6
10024,2024-07,172,62,85,25,171,1
10024,2024-08,164,69,68,27,163,1
10024,2024-09,187,56,102,29,185,2
10024,2024-10,210,82,97,31,207,3
10024,2024-11,179,57,105,17,178,1
10024,2024-12,146,55,70,21,144,2
10025,2020-01,439,114,262,63,433,6
10025,2020-02,337,90,210,37,332,5
10025,2020-03,341,106,194,41,337,4
10025,2020-04,211,62,109,40,205,6
10025,2020-05,241,62,146,33,237,4
10025,2020-06,335,89,201,45,331,4
10025,2020-07,320,89,200,31,319,1
10025,2020-08,367,116,203,48,362,5
10025,2020-09,360,109,193,58,356,4
10025,2020-10,302,92,165,45,297,5
10025,2020-11,300,91,161,48,295,5
10025,2020-12,286,91,172,23,278,8
10025,2021-01,293,73,176,44,287,6
10025,2021-02,235,65,129,41,231,4
10025,2021-03,277,99,129,49,272,4
10025,2021-04,299,77,184,38,294,5
10025,2021-05,345,118,181,46,331,14
10025,2021-06,297,98,153,46,291,6
10025,2021-07,320,102,170,48,314,6
10025,2021-08,376,123,206,47,364,12
10025,2021-09,329,112,167,50,327,2
10025,2021-10,455,154,245,56,446,9
10025,2021-11,414,138,221,55,406,8
10025,2021-12,362,110,199,53,356,6
10025,2022-01,385,126,214,45,380,5
10025,2022-02,364,102,220,42,361,3
10025,2022-03,399,100,254,45,394,5
10025,2022-04,365,115,195,55,358,7
10025,2022-05,365,109,202,54,357,8
10025,2022-06,424,122,235,67,420,4
10025,2022-07,422,127,224,71,411,11
10025,2022-08,459,126,261,72,454,5
10025,2022-09,431,116,257,58,423,8
10025,2022-10,452,117,275,60,445,7
10025,2022-11,365,116,201,48,357,8
10025,2022-12,369,100,211,58,366,3
10025,2023-01,509,144,311,54,501,8
10025,2023-02,346,94,204,48,340,6
10025,2023-03,395,120,228,47,392,3
10025,2023-04,369,95,222,52,365,4
10025,2023-05,424,121,252,51,419,5
10025,2023-06,382,108,227,47,379,3
10025,2023-07,393,130,210,53,389,4
10025,2023-08,359,106,206,47,356,3
10025,2023-09,338,105,194,39,336,2
10025,2023-10,411,124,218,69,407,4
10025,2023-11,383,116,198,69,380,3
10025,2023-12,356,112,194,50,353,3
10025,2024-01,333,110,178,45,329,4
10025,2024-02,307,89,170,48,303,4
10025,2024-03,344,107,178,59,343,1
10025,2024-04,300,106,140,54,295,5
10025,2024-05,311,89,149,73,308,3
10025,2024-06,316,111,158,47,314,2
10025,2024-07,395,114,222,59,390,5
10025,2024-08,311,108,167,36,308,3
10025,2024-09,363,106,206,51,360,3
10025,2024-10,383,112,211,60,378,5
10025,2024-11,373,97,218,58,368,5
10025,2024-12,296,72,189,35,292,4
10026,2020-01,236,78,130,28,234,2
10026,2020-02,209,63,108,38,205,4
10026,2020-03,183,59,87,37,180,3
10026,2020-04,169,48,93,28,166,3
10026,2020-05,206,56,131,19,205,1
10026,2020-06,164,52,86,26,161,3
10026,2020-07,192,48,113,31,192,0
10026,2020-08,192,76,98,18,187,5
10026,2020-09,186,64,84,38,184,2
10026,2020-10,193,61,103,29,192,1
10026,2020-11,202,69,101,32,202,0
10026,2020-12,202,55,115,32,197,5
10026,2021-01,178,51,96,31,174,4
10026,2021-02,164,46,85,33,162,2
10026,2021-03,208,57,117,34,202,6
10026,2021-04,215,73,103,39,212,3
10026,2021-05,239,81,122,36,235,4
10026,2021-06,254,92,120,42,247,7
10026,2021-07,186,68,85,33,183,3
10026,2021-08,182,57,87,38,176,6
10026,2021-09,207,71,104,32,199,8
10026,2021-10,215,66,113,36,214,1
10026,2021-11,164,54,75,35,163,1
10026,2021-12,203,56,118,29,198,5
10026,2022-01,221,72,107,42,215,6
10026,2022-02,214,80,98,36,211,3
10026,2022-03,225,79,107,39,218,7
10026,2022-04,237,81,123,33,234,3
10026,2022-05,225,86,111,28,223,2
10026,2022-06,239,85,120,34,234,5
10026,2022-07,254,85,131,38,250,4
10026,2022-08,240,82,126,32,236,4
10026,2022-09,250,90,139,21,248,2
10026,2022-10,233,87,123,23,232,1
10026,2022-11,216,76,105,35,211,5
10026,2022-12,203,84,104,15,198,5
10026,2023-01,187,68,89,30,184,3
10026,2023-02,202,81,81,40,198,4
10026,2023-03,231,87,111,33,228,3
10026,2023-04,210,68,100,42,207,3
10026,2023-05,234,66,125,43,232,2
10026,2023-06,230,81,116,33,222,8
10026,2023-07,259,86,128,45,257,2
10026,2023-08,205,81,93,31,199,6
10026,2023-09,221,80,99,42,215,6
10026,2023-10,213,67,105,41,211,2
10026,2023-11,214,66,95,53,207,7
10026,2023-12,164,51,78,35,161,3
10026,2024-01,200,65,85,50,198,2
10026,2024-02,187,64,81,42,185,2
10026,2024-03,189,75,90,24,186,3
10026,2024-04,226,75,113,38,219,7
10026,2024-05,258,91,126,41,251,7
10026,2024-06,233,75,113,45,231,2
10026,2024-07,226,79,110,37,225,1
10026,2024-08,197,71,95,31,193,4
10026,2024-09,220,78,96,46,220,0
10026,2024-10,198,70,97,31,197,1
10026,2024-11,230,89,103,38,227,3
10026,2024-12,215,64,112,39,214,1
10027,2020-01,545,155,314,76,532,13
10027,2020-02,483,139,262,82,477,6
10027,2020-03,469,148,229,92,462,7
10027,2020-04,275,92,131,52,264,11
10027,2020-05,352,101,200,51,344,8
10027,2020-06,335,106,178,51,325,10
10027,2020-07,446,152,230,64,441,5
10027,2020-08,500,190,244,66,495,5
10027,2020-09,461,156,238,67,457,4
10027,2020-10,539,160,297,82,534,5
10027,2020-11,447,137,243,67,440,7
10027,2020-12,404,113,218,73,400,4
10027,2021-01,403,124,220,59,400,3
10027,2021-02,357,94,203,60,355,2
10027,2021-03,473,136,265,72,463,9
10027,2021-04,415,124,222,69,407,8
10027,2021-05,548,156,283,109,545,3
10027,2021-06,573,164,318,91,562,11
10027,2021-07,625,185,353,87,615,10
10027,2021-08,557,166,307,84,551,6
10027,2021-09,550,176,274,100,546,4
10027,2021-10,568,214,271,83,559,9
10027,2021-11,524,175,279,70,513,11
10027,2021-12,494,153,271,70,486,8
10027,2022-01,483,166,244,73,475,8
10027,2022-02,535,183,275,77,524,11
10027,2022-03,506,144,283,79,497,9
10027,2022-04,546,179,276,91,533,13
10027,2022-05,537,179,269,89,532,5
10027,2022-06,504,157,263,84,493,11
10027,2022-07,547,202,275,70,538,9
10027,2022-08,480,182,234,64,468,12
10027,2022-09,468,164,232,72,459,9
10027,2022-10,514,176,248,90,510,4
10027,2022-11,556,198,276,82,547,9
10027,2022-12,499,185,245,69,490,9
10027,2023-01,537,168,279,90,526,11
10027,2023-02,456,134,257,65,449,7
10027,2023-03,499,185,238,76,492,7
10027,2023-04,569,186,302,81,554,15
10027,2023-05,599,191,323,85,584,15
10027,2023-06,557,177,290,90,546,11
10027,2023-07,521,187,263,71,511,10
10027,2023-08,551,191,283,77,536,15
10027,2023-09,551,193,280,78,541,10
10027,2023-10,606,216,302,88,591,15
10027,2023-11,494,155,260,79,488,6
10027,2023-12,487,154,247,86,477,10
10027,2024-01,498,170,247,81,486,12
10027,2024-02,515,163,257,95,506,9
10027,2024-03,541,182,264,95,532,9
10027,2024-04,605,182,337,86,597,8
10027,2024-05,511,149,263,99,506,5
10027,2024-06,593,182,328,83,585,8
10027,2024-07,651,208,333,110,642,9
10027,2024-08,567,156,313,98,550,17
10027,2024-09,557,154,305,98,541,16
10027,2024-10,651,194,364,93,639,12
10027,2024-11,559,179,293,87,549,10
10027,2024-12,494,146,275,73,487,7
10028,2020-01,126,46,70,10,124,2
10028,2020-02,114,32,67,15,110,4
10028,2020-03,96,31,56,9,94,2
10028,2020-04,85,31,48,6,83,2
10028,2020-05,116,42,64,10,114,2
10028,2020-06,104,35,54,15,101,3
10028,2020-07,127,44,74,9,125,2
10028,2020-08,136,62,62,12,130,6
10028,2020-09,138,58,73,7,137,1
10028,2020-10,113,46,53,14,110,3
10028,2020-11,86,36,39,11,86,0
10028,2020-12,91,35,45,11,89,2
10028,2021-01,84,34,41,9,81,3
10028,2021-02,61,21,32,8,61,0
10028,2021-03,65,23,30,12,64,1
10028,2021-04,79,24,43,12,77,2
10028,2021-05,91,30,50,11,90,1
10028,2021-06,84,43,34,7,82,2
10028,2021-07,84,32,34,18,82,2
10028,2021-08,97,36,45,16,96,1
10028,2021-09,98,41,49,8,98,0
10028,2021-10,113,47,53,13,109,4
10028,2021-11,75,31,39,5,73,2
10028,2021-12,97,46,40,11,91,6
10028,2022-01,72,28,36,8,71,1
10028,2022-02,121,47,60,14,119,2
10028,2022-03,147,38,92,17,145,2
10028,2022-04,136,50,70,16,134,2
10028,2022-05,129,41,77,11,128,1
10028,2022-06,133,48,67,18,130,3
10028,2022-07,143,52,81,10,140,3
10028,2022-08,159,44,94,21,156,3
10028,2022-09,121,43,72,6,118,3
10028,2022-10,123,52,58,13,123,0
10028,2022-11,134,42,72,20,130,4
10028,2022-12,117,46,62,9,115,2
10028,2023-01,143,44,86,13,140,3
10028,2023-02,105,39,56,10,104,1
10028,2023-03,114,45,55,14,113,1
10028,2023-04,113,38,54,21,112,1
10028,2023-05,136,51,62,23,135,1
10028,2023-06,139,56,66,17,138,1
10028,2023-07,176,60,104,12,173,3
10028,2023-08,150,47,84,19,149,1
10028,2023-09,118,42,63,13,118,0
10028,2023-10,125,39,65,21,125,0
10028,2023-11,113,39,61,13,112,1
10028,2023-12,92,28,47,17,89,3
10028,2024-01,106,34,60,12,106,0
10028,2024-02,78,31,36,11,77,1
10028,2024-03,113,32,64,17,113,0
10028,2024-04,97,35,45,17,97,0
10028,2024-05,123,45,60,18,122,1
10028,2024-06,106,35,47,24,105,1
10028,2024-07,112,44,52,16,112,0
10028,2024-08,106,41,58,7,104,2
10028,2024-09,97,32,48,17,95,2
10028,2024-10,130,44,76,10,128,2
10028,2024-11,107,30,63,14,107,0
10028,2024-12,101,34,57,10,100,1
10029,2020-01,524,145,295,84,514,10
10029,2020-02,441,117,242,82,435,6
10029,2020-03,451,128,236,87,445,6
10029,2020-04,366,106,208,52,358,8
10029,2020-05,461,135,254,72,448,13
10029,2020-06,461,148,233,80,457,4
10029,2020-07,490,152,241,97,485,5
10029,2020-08,477,138,245,94,471,6
10029,2020-09,532,151,271,110,524,8
10029,2020-10,482,144,252,86,470,12
10029,2020-11,475,150,245,80,468,7
10029,2020-12,466,151,228,87,455,11
10029,2021-01,470,144,243,83,464,6
10029,2021-02,406,111,206,89,394,12
10029,2021-03,465,132,229,104,459,6
10029,2021-04,502,121,276,105,494,8
10029,2021-05,505,150,273,82,496,9
10029,2021-06,490,159,225,106,485,5
10029,2021-07,512,168,245,99,500,12
10029,2021-08,548,175,245,128,536,12
10029,2021-09,507,152,262,93,496,11
10029,2021-10,489,149,247,93,475,14
10029,2021-11,523,168,245,110,512,11
10029,2021-12,464,164,216,84,454,10
10029,2022-01,499,152,241,106,489,10
10029,2022-02,449,145,203,101,441,8
10029,2022-03,555,125,307,123,547,8
10029,2022-04,534,168,279,87,522,12
10029,2022-05,693,233,339,121,678,15
10029,2022-06,661,185,352,124,646,15
10029,2022-07,512,170,238,104,501,11
10029,2022-08,599,185,299,115,591,8
10029,2022-09,611,194,314,103,595,16
10029,2022-10,603,180,323,100,598,5
10029,2022-11,551,165,296,90,540,11
10029,2022-12,493,150,235,108,483,10
10029,2023-01,564,170,269,125,551,13
10029,2023-02,530,145,271,114,519,11
10029,2023-03,575,165,295,115,562,13
10029,2023-04,544,165,292,87,534,10
10029,2023-05,592,168,293,131,579,13
10029,2023-06,654,183,355,116,640,14
10029,2023-07,606,173,318,115,600,6
10029,2023-08,577,175,280,122,567,10
10029,2023-09,582,186,291,105,573,9
10029,2023-10,625,190,296,139,618,7
10029,2023-11,615,183,309,123,602,13
10029,2023-12,573,168,290,115,562,11
10029,2024-01,539,164,231,144,529,10
10029,2024-02,538,132,278,128,530,8
10029,2024-03,574,176,290,108,556,18
10029,2024-04,567,168,276,123,554,13
10029,2024-05,639,184,334,121,619,20
10029,2024-06,593,189,280,124,574,19
10029,2024-07,572,180,284,108,560,12
10029,2024-08,546,177,263,106,536,10
10029,2024-09,585,198,281,106,567,18
10029,2024-10,676,200,350,126,663,13
10029,2024-11,509,162,256,91,496,13
10029,2024-12,431,133,199,99,421,10
10030,2020-01,203,52,121,30,202,1
10030,2020-02,165,41,84,40,164,1
10030,2020-03,163,42,90,31,161,2
10030,2020-04,127,41,68,18,124,3
10030,2020-05,159,39,95,25,157,2
10030,2020-06,197,65,102,30,192,5
10030,2020-07,162,51,69,42,159,3
10030,2020-08,193,66,93,34,190,3
10030,2020-09,201,56,117,28,195,6
10030,2020-10,213,74,97,42,211,2
10030,2020-11,205,68,102,35,202,3
10030,2020-12,172,55,81,36,171,1
10030,2021-01,223,67,109,47,220,3
10030,2021-02,133,33,72,28,132,1
10030,2021-03,220,70,114,36,214,5
10030,2021-04,182,69,80,33,176,6
10030,2021-05,217,66,108,43,214,3
10030,2021-06,201,71,97,33,198,3
10030,2021-07,244,79,131,34,242,2
10030,2021-08,241,65,135,41,236,5
10030,2021-09,223,72,111,40,219,4
10030,2021-10,258,78,128,52,249,9
10030,2021-11,204,71,104,29,200,4
10030,2021-12,208,71,100,37,202,6
10030,2022-01,222,66,100,56,218,4
10030,2022-02,217,78,100,39,213,4
10030,2022-03,247,80,127,40,241,6
10030,2022-04,280,88,144,48,278,2
10030,2022-05,237,79,118,40,232,5
10030,2022-06,250,102,114,34,243,7
10030,2022-07,212,60,124,28,210,2
10030,2022-08,237,65,125,47,235,2
10030,2022-09,205,69,95,41,204,1
10030,2022-10,252,67,135,50,252,0
10030,2022-11,218,63,114,41,214,4
10030,2022-12,220,68,118,34,213,7
10030,2023-01,214,65,117,32,209,5
10030,2023-02,194,60,94,40,187,7
10030,2023-03,216,71,102,43,213,3
10030,2023-04,210,59,110,41,205,5
10030,2023-05,243,84,109,50,239,4
10030,2023-06,238,71,128,39,234,4
10030,2023-07,274,96,136,42,273,1
10030,2023-08,278,96,139,43,275,3
10030,2023-09,241,86,115,40,235,6
10030,2023-10,221,87,97,37,214,7
10030,2023-11,210,65,106,39,206,4
10030,2023-12,255,87,111,57,251,4
10030,2024-01,186,55,92,39,180,6
10030,2024-02,238,58,134,46,232,6
10030,2024-03,220,56,115,49,213,7
10030,2024-04,233,70,121,42,227,6
10030,2024-05,268,78,131,59,266,2
10030,2024-06,231,79,109,43,228,3
10030,2024-07,254,85,117,52,250,4
10030,2024-08,229,52,123,54,225,4
10030,2024-09,267,66,127,74,264,3
10030,2024-10,282,54,160,68,276,6
10030,2024-11,239,70,111,58,233,6
10030,2024-12,248,63,112,73,246,2
10031,2020-01,312,90,182,40,308,4
10031,2020-02,298,87,150,61,293,5
10031,2020-03,299,85,158,56,294,5
10031,2020-04,290,59,183,48,284,6
10031,2020-05,318,78,193,47,310,8
10031,2020-06,274,62,166,46,267,7
10031,2020-07,325,84,172,69,321,4
10031,2020-08,284,70,161,53,280,4
10031,2020-09,331,88,178,65,327,4
10031,2020-10,299,96,157,46,292,7
10031,2020-11,296,88,168,40,294,2
10031,2020-12,264,82,139,43,261,3
10031,2021-01,271,97,142,32,268,3
10031,2021-02,206,75,93,38,198,8
10031,2021-03,256,73,143,40,255,1
10031,2021-04,280,85,149,46,270,7
10031,2021-05,303,75,173,55,300,3
10031,2021-06,324,97,162,65,320,4
10031,2021-07,373,108,215,50,369,4
10031,2021-08,358,89,214,55,356,2
10031,2021-09,400,104,236,60,395,5
10031,2021-10,391,107,229,55,389,2
10031,2021-11,380,101,215,64,378,2
10031,2021-12,357,99,192,66,354,3
10031,2022-01,364,102,200,62,360,4
10031,2022-02,319,82,186,51,317,2
10031,2022-03,392,102,234,56,387,5
10031,2022-04,422,118,252,52,418,4
10031,2022-05,410,107,236,67,406,4
10031,2022-06,434,120,252,62,427,7
10031,2022-07,418,126,236,56,412,6
10031,2022-08,396,105,219,72,390,6
10031,2022-09,391,99,237,55,386,5
10031,2022-10,352,99,196,57,349,3
10031,2022-11,293,87,146,60,291,2
10031,2022-12,307,89,149,69,304,3
10031,2023-01,377,114,199,64,371,6
10031,2023-02,317,96,164,57,313,4
10031,2023-03,286,104,136,46,281,5
10031,2023-04,274,73,154,47,269,5
10031,2023-05,344,104,185,55,339,5
10031,2023-06,393,128,200,65,388,5
10031,2023-07,437,131,239,67,434,3
10031,2023-08,377,119,206,52,371,6
10031,2023-09,357,109,173,75,352,5
10031,2023-10,373,98,197,78,368,5
10031,2023-11,326,108,164,54,324,2
10031,2023-12,337,98,179,60,333,4
10031,2024-01,349,105,190,54,347,2
10031,2024-02,303,76,173,54,298,5
10031,2024-03,320,84,196,40,316,4
10031,2024-04,346,116,199,31,337,9
10031,2024-05,363,113,178,72,357,6
10031,2024-06,353,116,181,56,347,6
10031,2024-07,348,108,182,58,342,6
10031,2024-08,415,126,236,53,404,11
10031,2024-09,371,122,191,58,365,6
10031,2024-10,403,96,253,54,392,11
10031,2024-11,357,99,190,68,355,2
10031,2024-12,291,78,165,48,283,8
10032,2020-01,245,70,146,29,242,3
10032,2020-02,232,80,112,40,227,5
10032,2020-03,242,81,118,43,238,4
10032,2020-04,195,69,98,28,188,7
10032,2020-05,281,93,149,39,277,4
10032,2020-06,237,81,110,46,235,2
10032,2020-07,190,69,92,29,184,6
10032,2020-08,272,88,131,53,266,6
10032,2020-09,277,97,134,46,273,4
10032,2020-10,289,98,153,38,285,4
10032,2020-11,266,74,139,53,265,1
10032,2020-12,220,82,105,33,213,7
10032,2021-01,279,104,131,44,274,5
10032,2021-02,264,89,132,43,255,9
10032,2021-03,319,107,158,54,314,4
10032,2021-04,320,89,179,52,318,2
10032,2021-05,349,101,197,51,344,5
10032,2021-06,339,88,187,64,332,7
10032,2021-07,323,100,177,46,319,4
10032,2021-08,344,106,190,48,335,9
10032,2021-09,355,100,212,43,351,4
10032,2021-10,316,102,169,45,313,3
10032,2021-11,330,98,187,45,320,10
10032,2021-12,300,92,174,34,290,10
10032,2022-01,252,78,149,25,251,1
10032,2022-02,272,86,144,42,266,6
10032,2022-03,321,96,182,43,319,2
10032,2022-04,314,90,177,47,311,3
10032,2022-05,300,86,154,60,293,7
10032,2022-06,329,100,171,58,325,4
10032,2022-07,304,97,145,62,303,1
10032,2022-08,278,89,143,46,274,4
10032,2022-09,250,75,129,46,245,5
10032,2022-10,310,102,164,44,302,8
10032,2022-11,274,96,137,41,269,5
10032,2022-12,270,72,153,45,270,0
10032,2023-01,323,110,152,61,318,5
10032,2023-02,295,112,138,45,291,4
10032,2023-03,340,106,178,56,334,6
10032,2023-04,301,106,151,44,298,3
10032,2023-05,308,104,161,43,303,5
10032,2023-06,345,130,162,53,343,2
10032,2023-07,366,134,168,64,362,4
10032,2023-08,378,134,199,45,372,6
10032,2023-09,338,140,156,42,333,5
10032,2023-10,302,95,159,48,299,3
10032,2023-11,280,93,148,39,278,2
10032,2023-12,284,99,137,48,280,4
10032,2024-01,319,114,157,48,311,8
10032,2024-02,249,84,119,46,248,1
10032,2024-03,310,105,159,46,309,1
10032,2024-04,312,99,174,39,307,5
10032,2024-05,348,113,177,58,343,5
10032,2024-06,315,108,162,45,310,5
10032,2024-07,287,105,152,30,283,4
10032,2024-08,323,122,154,47,321,2
10032,2024-09,309,123,140,46,307,2
10032,2024-10,339,114,169,56,335,4
10032,2024-11,276,91,147,38,272,4
10032,2024-12,269,100,130,39,268,1
10033,2020-01,261,92,132,37,254,7
10033,2020-02,225,73,122,30,221,4
10033,2020-03,202,56,107,39,198,4
10033,2020-04,174,59,91,24,169,5
10033,2020-05,226,68,128,30,218,8
10033,2020-06,192,53,102,37,190,2
10033,2020-07,191,68,90,33,184,7
10033,2020-08,247,87,120,40,237,10
10033,2020-09,231,101,98,32,226,5
10033,2020-10,271,112,132,27,264,7
10033,2020-11,228,85,108,35,222,6
10033,2020-12,224,94,100,30,221,3
10033,2021-01,242,87,124,31,239,3
10033,2021-02,202,90,86,26,199,3
10033,2021-03,193,72,89,32,192,1
10033,2021-04,210,64,113,33,207,3
10033,2021-05,276,80,163,33,273,3
10033,2021-06,270,69,162,39,264,6
10033,2021-07,279,81,157,41,272,7
10033,2021-08,342,98,208,36,337,5
10033,2021-09,282,92,143,47,281,1
10033,2021-10,363,118,212,33,362,1
10033,2021-11,318,91,185,42,315,3
10033,2021-12,212,67,117,28,206,6
10033,2022-01,285,93,162,30,284,1
10033,2022-02,353,99,220,34,345,8
10033,2022-03,389,102,239,48,384,5
10033,2022-04,319,98,180,41,315,4
10033,2022-05,344,112,191,41,338,6
10033,2022-06,347,83,221,43,343,4
10033,2022-07,411,112,249,50,406,5
10033,2022-08,341,102,205,34,336,5
10033,2022-09,332,93,203,36,328,4
10033,2022-10,316,106,158,52,313,3
10033,2022-11,330,83,199,48,325,5
10033,2022-12,286,82,176,28,282,4
10033,2023-01,332,114,178,40,329,3
10033,2023-02,244,73,144,27,236,8
10033,2023-03,361,124,186,51,356,5
10033,2023-04,306,109,159,38,301,5
10033,2023-05,330,97,195,38,329,1
10033,2023-06,311,96,177,38,308,3
10033,2023-07,311,103,180,28,306,5
10033,2023-08,321,98,185,38,319,2
10033,2023-09,295,87,171,37,288,7
10033,2023-10,307,96,166,45,300,7
10033,2023-11,299,95,159,45,294,5
10033,2023-12,261,92,142,27,256,5
10033,2024-01,309,91,176,42,304,5
10033,2024-02,264,84,141,39,256,8
10033,2024-03,303,105,172,26,292,11
10033,2024-04,295,90,158,47,293,2
10033,2024-05,326,96,176,54,321,5
10033,2024-06,323,112,191,20,321,2
10033,2024-07,337,82,228,27,336,1
10033,2024-08,316,98,194,24,316,0
10033,2024-09,296,96,166,34,287,9
10033,2024-10,306,85,182,39,303,3
10033,2024-11,305,103,170,32,300,5
10033,2024-12,262,80,157,25,260,2
10034,2020-01,174,66,77,31,171,3
10034,2020-02,131,61,52,18,128,3
10034,2020-03,159,44,92,23,155,4
10034,2020-04,113,29,66,18,109,4
10034,2020-05,166,57,80,29,163,3
10034,2020-06,141,49,68,24,139,2
10034,2020-07,165,56,84,25,163,2
10034,2020-08,165,57,90,18,163,2
10034,2020-09,206,81,99,26,203,3
10034,2020-10,173,61,86,26,169,4
10034,2020-11,157,75,61,21,156,1
10034,2020-12,154,61,70,23,152,2
10034,2021-01,137,51,68,18,137,0
10034,2021-02,141,51,75,15,140,1
10034,2021-03,148,61,67,20,146,2
10034,2021-04,152,56,76,20,151,1
10034,2021-05,195,71,101,23,193,2
10034,2021-06,229,82,114,33,225,4
10034,2021-07,193,78,85,30,189,4
10034,2021-08,208,86,87,35,204,4
10034,2021-09,183,71,78,34,182,1
10034,2021-10,174,60,80,34,173,1
10034,2021-11,190,88,78,24,187,3
10034,2021-12,176,74,69,33,171,5
10034,2022-01,165,78,60,27,162,3
10034,2022-02,164,68,79,17,159,5
10034,2022-03,196,66,97,33,196,0
10034,2022-04,174,67,78,29,170,4
10034,2022-05,164,63,70,31,157,7
10034,2022-06,154,63,66,25,152,2
10034,2022-07,181,76,70,35,178,3
10034,2022-08,206,78,100,28,202,4
10034,2022-09,189,60,89,40,184,5
10034,2022-10,225,84,104,37,224,1
10034,2022-11,209,69,117,23,206,3
10034,2022-12,242,90,112,40,236,6
10034,2023-01,250,83,136,31,246,4
10034,2023-02,205,68,112,25,203,2
10034,2023-03,212,76,110,26,209,3
10034,2023-04,195,61,102,32,190,5
10034,2023-05,277,76,156,45,276,1
10034,2023-06,208,76,107,25,207,1
10034,2023-07,209,81,94,34,206,3
10034,2023-08,211,84,104,23,208,3
10034,2023-09,207,69,95,43,204,3
10034,2023-10,224,80,110,34,224,0
10034,2023-11,193,69,91,33,186,7
10034,2023-12,197,84,86,27,195,2
10034,2024-01,192,77,100,15,189,3
10034,2024-02,211,76,112,23,205,6
10034,2024-03,233,75,132,26,230,3
10034,2024-04,178,64,97,17,178,0
10034,2024-05,249,86,136,27,245,4
10034,2024-06,214,71,127,16,212,2
10034,2024-07,219,61,123,35,219,0
10034,2024-08,252,86,148,18,252,0
10034,2024-09,215,70,117,28,212,3
10034,2024-10,206,66,115,25,205,1
10034,2024-11,219,69,128,22,216,3
10034,2024-12,188,57,102,29,188,0
10035,2020-01,540,131,359,50,528,12
10035,2020-02,456,114,289,53,452,4
10035,2020-03,448,134,275,39,442,6
10035,2020-04,281,85,163,33,274,7
10035,2020-05,440,128,283,29,436,4
10035,2020-06,350,122,169,59,345,5
10035,2020-07,372,137,182,53,370,2
10035,2020-08,410,131,231,48,409,1
10035,2020-09,409,123,228,58,406,3
10035,2020-10,476,145,277,54,468,8
10035,2020-11,395,133,207,55,389,6
10035,2020-12,392,140,216,36,390,2
10035,2021-01,398,121,237,40,394,4
10035,2021-02,328,94,196,38,325,3
10035,2021-03,423,124,247,52,415,8
10035,2021-04,362,121,197,44,356,5
10035,2021-05,426,141,223,62,422,4
10035,2021-06,405,146,205,54,396,9
10035,2021-07,453,144,260,49,441,12
10035,2021-08,494,148,288,58,487,7
10035,2021-09,525,180,289,56,520,5
10035,2021-10,488,163,258,67,479,9
10035,2021-11,496,142,294,60,482,14
10035,2021-12,434,150,231,53,431,3
10035,2022-01,437,150,226,61,432,5
10035,2022-02,430,153,226,51,419,11
10035,2022-03,584,195,324,65,568,16
10035,2022-04,493,172,260,61,483,10
10035,2022-05,529,173,266,90,518,11
10035,2022-06,578,183,309,86,570,8
10035,2022-07,512,170,277,65,502,10
10035,2022-08,524,145,303,76,519,5
10035,2022-09,607,251,310,46,600,7
10035,2022-10,533,151,312,70,527,6
10035,2022-11,461,131,265,65,454,7
10035,2022-12,466,143,256,67,461,5
10035,2023-01,506,141,285,80,494,12
10035,2023-02,475,119,293,63,465,10
10035,2023-03,501,146,273,82,496,5
10035,2023-04,497,142,303,52,491,6
10035,2023-05,512,152,280,80,508,4
10035,2023-06,565,212,264,89,555,10
10035,2023-07,655,192,373,90,647,8
10035,2023-08,660,199,372,89,645,15
10035,2023-09,783,287,418,78,771,12
10035,2023-10,710,193,450,67,696,14
10035,2023-11,552,170,304,78,546,6
10035,2023-12,490,162,273,55,473,17
10035,2024-01,551,173,315,63,544,7
10035,2024-02,494,183,259,52,484,10
10035,2024-03,502,161,260,81,495,7
10035,2024-04,559,212,266,81,555,4
10035,2024-05,560,185,281,94,552,8
10035,2024-06,583,194,305,84,574,9
10035,2024-07,538,196,250,92,531,7
10035,2024-08,565,193,263,109,558,7
10035,2024-09,452,145,238,69,449,3
10035,2024-10,545,167,300,78,538,7
10035,2024-11,472,156,222,94,464,8
10035,2024-12,376,120,184,72,370,6
10036,2020-01,361,130,197,34,354,7
10036,2020-02,347,113,195,39,339,8
10036,2020-03,265,99,134,32,262,3
10036,2020-04,114,50,45,19,112,2
10036,2020-05,161,55,84,22,157,4
10036,2020-06,209,89,84,36,207,2
10036,2020-07,207,80,92,35,201,6
10036,2020-08,238,89,113,36,238,0
10036,2020-09,244,82,126,36,240,4
10036,2020-10,284,114,122,48,273,11
10036,2020-11,264,101,125,38,259,5
10036,2020-12,235,85,116,34,227,8
10036,2021-01,264,95,117,52,259,5
10036,2021-02,238,78,112,48,230,8
10036,2021-03,323,99,180,44,315,7
10036,2021-04,298,88,145,65,293,5
10036,2021-05,423,131,244,48,413,10
10036,2021-06,424,124,249,51,417,7
10036,2021-07,396,143,208,45,387,9
10036,2021-08,424,142,236,46,413,11
10036,2021-09,479,180,237,62,466,13
10036,2021-10,503,155,284,64,496,7
10036,2021-11,440,153,227,60,440,0
10036,2021-12,361,133,195,33,358,3
10036,2022-01,390,161,162,67,381,9
10036,2022-02,394,160,191,43,383,11
10036,2022-03,422,163,206,53,411,11
10036,2022-04,420,157,204,59,412,8
10036,2022-05,492,193,235,64,486,6
10036,2022-06,518,186,259,73,509,9
10036,2022-07,550,209,288,53,545,5
10036,2022-08,498,190,251,57,490,8
10036,2022-09,548,192,287,69,542,6
10036,2022-10,593,192,324,77,584,9
10036,2022-11,628,209,337,82,621,7
10036,2022-12,567,258,263,46,558,9
10036,2023-01,582,198,313,71,571,11
10036,2023-02,467,181,231,55,457,10
10036,2023-03,522,199,262,61,512,10
10036,2023-04,533,213,238,82,524,9
10036,2023-05,541,173,303,65,532,9
10036,2023-06,540,173,301,66,535,5
10036,2023-07,632,223,343,66,617,15
10036,2023-08,589,222,308,59,578,11
10036,2023-09,497,186,266,45,490,7
10036,2023-10,638,197,360,81,630,8
10036,2023-11,607,206,349,52,598,9
10036,2023-12,649,255,337,57,637,12
10036,2024-01,605,198,338,69,597,8
10036,2024-02,624,195,344,85,614,10
10036,2024-03,596,190,333,73,591,5
10036,2024-04,600,188,342,70,597,3
10036,2024-05,766,240,452,74,762,4
10036,2024-06,623,190,379,54,619,4
10036,2024-07,857,267,531,59,850,7
10036,2024-08,821,259,490,72,811,10
10036,2024-09,670,209,403,58,663,7
10036,2024-10,685,226,388,71,679,6
10036,2024-11,597,200,326,71,593,4
10036,2024-12,595,193,347,55,589,6
10037,2020-01,89,18,54,17,87,2
10037,2020-02,69,21,41,7,68,1
10037,2020-03,81,25,46,10,80,1
10037,2020-04,62,21,26,15,61,1
10037,2020-05,79,24,47,8,77,2
10037,2020-06,79,27,42,10,79,0
10037,2020-07,108,35,57,16,104,4
10037,2020-08,98,34,52,12,96,2
10037,2020-09,108,40,53,15,107,1
10037,2020-10,119,39,55,25,118,1
10037,2020-11,114,33,61,20,111,3
10037,2020-12,84,29,44,11,84,0
10037,2021-01,101,40,44,17,100,1
10037,2021-02,86,32,36,18,85,1
10037,2021-03,119,43,62,14,114,4
10037,2021-04,103,39,43,21,98,4
10037,2021-05,105,37,51,17,103,2
10037,2021-06,84,26,47,11,82,2
10037,2021-07,128,37,67,24,126,2
10037,2021-08,108,33,56,19,104,4
10037,2021-09,137,47,66,24,137,0
10037,2021-10,106,38,48,20,105,1
10037,2021-11,115,40,56,19,112,3
10037,2021-12,135,34,75,26,135,0
10037,2022-01,90,35,39,16,87,3
10037,2022-02,107,47,42,18,104,3
10037,2022-03,124,36,60,28,120,4
10037,2022-04,111,42,56,13,104,7
10037,2022-05,117,41,50,26,116,1
10037,2022-06,136,56,61,19,134,2
10037,2022-07,104,26,55,23,101,3
10037,2022-08,112,32,54,26,111,1
10037,2022-09,108,39,51,18,106,2
10037,2022-10,126,41,62,23,122,4
10037,2022-11,108,41,47,20,108,0
10037,2022-12,94,35,43,16,94,0
10037,2023-01,114,34,63,17,111,3
10037,2023-02,105,29,54,22,103,2
10037,2023-03,110,27,47,36,106,4
10037,2023-04,121,44,59,18,121,0
10037,2023-05,114,42,41,31,112,2
10037,2023-06,127,47,63,17,123,4
10037,2023-07,158,64,61,33,156,2
10037,2023-08,144,66,53,25,139,5
10037,2023-09,106,49,45,12,105,1
10037,2023-10,119,46,52,21,115,4
10037,2023-11,135,41,70,24,131,4
10037,2023-12,122,34,63,25,120,2
10037,2024-01,120,38,46,36,114,6
10037,2024-02,113,43,53,17,111,2
10037,2024-03,142,57,60,25,140,2
10037,2024-04,143,54,60,29,143,0
10037,2024-05,144,40,78,26,141,3
10037,2024-06,120,43,56,21,118,2
10037,2024-07,142,41,74,27,138,4
10037,2024-08,112,38,56,18,111,1
10037,2024-09,164,54,84,26,162,2
10037,2024-10,139,36,79,24,137,2
10037,2024-11,123,33,67,23,122,1
10037,2024-12,94,27,39,28,92,2
10038,2020-01,132,46,68,18,131,1
10038,2020-02,130,41,67,22,127,3
10038,2020-03,105,24,57,24,100,5
10038,2020-04,68,18,27,23,67,1
10038,2020-05,70,17,39,14,67,3
10038,2020-06,76,20,39,17,76,0
10038,2020-07,81,21,45,15,79,2
10038,2020-08,114,28,62,24,112,2
10038,2020-09,107,26,67,14,105,2
10038,2020-10,96,26,55,15,95,1
10038,2020-11,75,24,39,12,74,1
10038,2020-12,91,32,47,12,91,0
10038,2021-01,78,22,44,12,78,0
10038,2021-02,89,28,45,16,89,0
10038,2021-03,98,23,59,16,98,0
10038,2021-04,87,17,52,18,87,0
10038,2021-05,95,18,59,18,94,1
10038,2021-06,108,26,65,17,108,0
10038,2021-07,113,32,57,24,112,1
10038,2021-08,124,35,63,26,124,0
10038,2021-09,116,23,73,20,116,0
10038,2021-10,129,47,59,23,127,2
10038,2021-11,103,23,61,19,103,0
10038,2021-12,106,32,55,19,103,3
10038,2022-01,102,30,56,16,102,0
10038,2022-02,131,32,83,16,129,2
10038,2022-03,108,24,70,14,106,2
10038,2022-04,139,37,83,19,136,3
10038,2022-05,117,25,77,15,116,1
10038,2022-06,126,36,66,24,126,0
10038,2022-07,120,30,73,17,120,0
10038,2022-08,133,35,76,22,133,0
10038,2022-09,163,40,103,20,161,2
10038,2022-10,153,28,112,13,153,0
10038,2022-11,165,28,120,17,165,0
10038,2022-12,127,22,89,16,126,1
10038,2023-01,137,28,95,14,137,0
10038,2023-02,138,17,106,15,137,1
10038,2023-03,169,32,116,21,169,0
10038,2023-04,160,30,115,15,159,1
10038,2023-05,166,30,115,21,166,0
10038,2023-06,164,34,111,19,163,1
10038,2023-07,135,31,87,17,135,0
10038,2023-08,180,40,117,23,180,0
10038,2023-09,170,39,106,25,170,0
10038,2023-10,188,24,135,29,187,1
10038,2023-11,223,42,155,26,223,0
10038,2023-12,176,32,112,32,175,1
10038,2024-01,163,34,68,61,162,1
10038,2024-02,158,40,95,23,157,1
10038,2024-03,163,30,108,25,162,1
10038,2024-04,157,24,104,29,155,2
10038,2024-05,151,33,94,24,151,0
10038,2024-06,142,44,79,19,142,0
10038,2024-07,134,31,79,24,134,0
10038,2024-08,129,33,75,21,129,0
10038,2024-09,133,41,65,27,132,1
10038,2024-10,172,42,102,28,170,2
10038,2024-11,160,21,118,21,159,1
10038,2024-12,144,31,97,16,142,2
10039,2020-01,165,54,88,23,163,2
10039,2020-02,140,31,84,25,140,0
10039,2020-03,128,41,55,32,127,1
10039,2020-04,114,33,59,22,112,2
10039,2020-05,168,50,93,25,167,1
10039,2020-06,125,36,69,20,123,2
10039,2020-07,121,41,56,24,120,1
10039,2020-08,144,45,68,31,142,2
10039,2020-09,129,44,63,22,127,2
10039,2020-10,152,45,73,34,147,5
10039,2020-11,145,39,73,33,144,1
10039,2020-12,174,57,80,37,170,4
10039,2021-01,156,45,79,32,153,3
10039,2021-02,108,30,47,31,105,3
10039,2021-03,139,46,64,29,137,2
10039,2021-04,119,31,59,29,116,1
10039,2021-05,143,44,69,30,140,3
10039,2021-06,154,57,76,21,148,6
10039,2021-07,177,60,73,44,176,1
10039,2021-08,195,55,102,38,191,4
10039,2021-09,154,51,70,33,152,2
10039,2021-10,174,56,78,40,169,5
10039,2021-11,152,56,66,30,151,1
10039,2021-12,145,44,56,45,143,2
10039,2022-01,135,54,48,33,134,1
10039,2022-02,153,43,75,35,149,4
10039,2022-03,157,57,67,33,153,4
10039,2022-04,152,49,64,39,148,4
10039,2022-05,140,43,64,33,140,0
10039,2022-06,163,48,85,30,157,6
10039,2022-07,167,60,70,37,166,1
10039,2022-08,148,51,54,43,146,2
10039,2022-09,148,41,70,37,146,2
10039,2022-10,147,45,70,32,145,2
10039,2022-11,162,46,77,39,158,4
10039,2022-12,156,52,65,39,155,1
10039,2023-01,136,52,59,25,131,5
10039,2023-02,159,56,67,36,157,2
10039,2023-03,153,39,81,33,153,0
10039,2023-04,136,37,77,22,132,4
10039,2023-05,134,48,59,27,133,1
10039,2023-06,172,60,82,30,166,6
10039,2023-07,174,59,74,41,172,2
10039,2023-08,206,69,90,47,200,6
10039,2023-09,219,84,102,33,218,1
10039,2023-10,170,51,84,35,165,5
10039,2023-11,171,53,95,23,167,4
10039,2023-12,161,55,78,28,158,3
10039,2024-01,169,47,77,45,167,2
10039,2024-02,132,27,75,30,132,0
10039,2024-03,177,52,83,42,176,1
10039,2024-04,196,57,96,43,193,3
10039,2024-05,208,66,98,44,203,5
10039,2024-06,174,50,92,32,172,2
10039,2024-07,216,64,102,50,213,3
10039,2024-08,184,61,83,40,179,5
10039,2024-09,159,56,70,33,157,2
10039,2024-10,178,53,77,48,172,6
10039,2024-11,190,67,82,41,188,2
10039,2024-12,189,51,100,38,186,3
10040,2020-01,140,50,72,18,138,2
10040,2020-02,101,40,45,16,96,5
10040,2020-03,106,31,55,20,104,2
10040,2020-04,110,39,60,11,108,2
10040,2020-05,140,48,77,15,138,2
10040,2020-06,120,40,61,19,117,3
10040,2020-07,121,43,51,27,119,2
10040,2020-08,103,35,53,15,102,1
10040,2020-09,128,53,49,26,127,1
10040,2020-10,124,42,61,21,122,2
10040,2020-11,138,52,66,20,135,3
10040,2020-12,106,37,52,17,105,1
10040,2021-01,127,54,56,17,127,0
10040,2021-02,79,30,41,8,78,1
10040,2021-03,105,32,48,25,105,0
10040,2021-04,120,36,60,24,117,3
10040,2021-05,109,45,45,19,108,1
10040,2021-06,130,52,59,19,130,0
10040,2021-07,139,37,72,30,138,1
10040,2021-08,111,50,38,23,111,0
10040,2021-09,117,44,46,27,116,1
10040,2021-10,131,40,57,34,127,4
10040,2021-11,123,43,67,13,120,3
10040,2021-12,114,50,46,18,112,2
10040,2022-01,109,47,48,14,104,5
10040,2022-02,137,39,73,25,136,1
10040,2022-03,147,44,78,25,143,4
10040,2022-04,142,45,71,26,138,4
10040,2022-05,156,58,68,30,154,2
10040,2022-06,144,44,73,27,143,1
10040,2022-07,144,50,70,24,141,3
10040,2022-08,122,33,66,23,120,2
10040,2022-09,126,34,65,27,123,3
10040,2022-10,132,45,73,14,129,3
10040,2022-11,137,39,78,20,135,2
10040,2022-12,134,39,62,33,132,2
10040,2023-01,152,51,81,20,148,4
10040,2023-02,130,49,59,22,128,2
10040,2023-03,166,44,89,33,163,3
10040,2023-04,133,49,62,22,131,2
10040,2023-05,187,62,92,33,185,2
10040,2023-06,180,70,77,33,177,3
10040,2023-07,162,62,70,30,160,2
10040,2023-08,142,47,69,26,140,2
10040,2023-09,136,31,69,36,133,3
10040,2023-10,138,59,57,22,135,3
10040,2023-11,155,50,71,34,154,1
10040,2023-12,148,53,72,23,143,5
10040,2024-01,163,51,82,30,160,3
10040,2024-02,175,66,92,17,173,2
10040,2024-03,155,45,82,28,150,5
10040,2024-04,173,54,96,23,170,3
10040,2024-05,192,78,90,24,191,1
10040,2024-06,169,53,99,17,166,3
10040,2024-07,170,54,97,19,167,3
10040,2024-08,189,60,109,20,186,3
10040,2024-09,157,60,83,14,153,4
10040,2024-10,176,42,102,32,176,0
10040,2024-11,163,54,93,16,161,2
10040,2024-12,139,36,80,23,138,1
10044,2020-01,11,3,6,2,11,0
10044,2020-02,14,3,6,5,14,0
10044,2020-03,4,2,1,1,4,0
10044,2020-04,1,0,1,0,1,0
10044,2020-05,6,4,2,0,6,0
10044,2020-06,10,5,4,1,10,0
10044,2020-07,13,4,6,3,12,1
10044,2020-08,10,3,5,2,10,0
10044,2020-09,8,1,4,3,8,0
10044,2020-10,26,10,14,2,26,0
10044,2020-11,14,3,6,5,14,0
10044,2020-12,9,2,6,1,9,0
10044,2021-01,7,4,3,0,7,0
10044,2021-02,5,1,4,0,5,0
10044,2021-03,8,3,2,3,8,0
10044,2021-04,7,1,3,3,7,0
10044,2021-05,5,1,3,1,5,0
10044,2021-06,10,3,4,3,10,0
10044,2021-07,18,3,7,8,18,0
10044,2021-08,22,7,12,3,22,0
10044,2021-09,10,2,5,3,10,0
10044,2021-10,16,1,8,7,16,0
10044,2021-11,13,5,7,1,13,0
10044,2021-12,10,3,6,1,10,0
10044,2022-01,15,5,9,1,15,0
10044,2022-02,9,2,6,1,9,0
10044,2022-03,18,6,7,5,17,1
10044,2022-04,15,5,6,4,15,0
10044,2022-05,23,7,9,7,23,0
10044,2022-06,19,7,7,5,19,0
10044,2022-07,17,7,7,3,17,0
10044,2022-08,15,4,8,3,15,0
10044,2022-09,9,2,5,2,9,0
10044,2022-10,21,4,9,8,21,0
10044,2022-11,12,2,8,2,12,0
10044,2022-12,10,2,6,2,10,0
10044,2023-01,14,4,7,3,14,0
10044,2023-02,10,3,3,4,10,0
10044,2023-03,17,7,8,2,17,0
10044,2023-04,16,6,7,3,16,0
10044,2023-05,16,5,9,2,16,0
10044,2023-06,13,6,4,3,13,0
10044,2023-07,13,6,5,2,13,0
10044,2023-08,17,4,11,2,17,0
10044,2023-09,20,7,8,5,19,1
10044,2023-10,21,3,9,9,21,0
10044,2023-11,20,3,9,8,20,0
10044,2023-12,12,6,5,1,11,1
10044,2024-01,8,0,5,3,8,0
10044,2024-02,19,3,10,6,19,0
10044,2024-03,9,0,6,3,9,0
10044,2024-04,19,10,6,3,18,1
10044,2024-05,25,6,11,8,25,0
10044,2024-06,17,3,7,7,17,0
10044,2024-07,19,6,10,3,19,0
10044,2024-08,23,5,11,7,23,0
10044,2024-09,16,6,6,4,16,0
10044,2024-10,17,8,6,3,17,0
10044,2024-11,23,9,9,5,23,0
10044,2024-12,20,5,10,5,19,1
10065,2020-01,146,56,76,14,140,6
10065,2020-02,178,52,108,18,175,3
10065,2020-03,123,38,67,18,121,2
10065,2020-04,73,23,42,8,72,1
10065,2020-05,88,24,59,5,86,2
10065,2020-06,105,45,53,7,98,7
10065,2020-07,104,39,50,15,102,2
10065,2020-08,144,61,68,15,141,3
10065,2020-09,162,69,78,15,159,3
10065,2020-10,124,49,61,14,119,5
10065,2020-11,123,40,72,11,123,0
10065,2020-12,95,33,48,14,94,1
10065,2021-01,116,35,69,12,114,2
10065,2021-02,103,29,59,15,101,2
10065,2021-03,131,45,72,14,127,4
10065,2021-04,108,28,70,10,107,1
10065,2021-05,125,37,71,17,123,2
10065,2021-06,96,28,48,20,93,3
10065,2021-07,122,45,62,15,119,3
10065,2021-08,114,46,58,10,112,2
10065,2021-09,143,57,62,24,137,6
10065,2021-10,136,58,58,20,133,3
10065,2021-11,122,54,49,19,119,3
10065,2021-12,112,53,44,15,109,3
10065,2022-01,111,48,48,15,108,3
10065,2022-02,108,46,50,12,103,5
10065,2022-03,123,37,70,16,123,0
10065,2022-04,108,50,46,12,106,2
10065,2022-05,157,80,63,14,153,4
10065,2022-06,123,48,60,15,121,2
10065,2022-07,120,54,51,15,118,2
10065,2022-08,127,62,51,14,125,2
10065,2022-09,135,56,61,18,133,2
10065,2022-10,114,44,49,21,108,6
10065,2022-11,131,55,55,21,127,4
10065,2022-12,130,65,50,15,123,7
10065,2023-01,96,38,46,12,94,2
10065,2023-02,98,34,51,13,98,0
10065,2023-03,104,52,45,7,102,2
10065,2023-04,129,61,51,17,129,0
10065,2023-05,156,71,63,22,155,1
10065,2023-06,126,55,61,10,125,1
10065,2023-07,115,49,59,7,115,0
10065,2023-08,136,64,56,16,133,3
10065,2023-09,117,39,59,19,115,2
10065,2023-10,121,51,56,14,118,3
10065,2023-11,128,51,65,12,127,1
10065,2023-12,116,55,48,13,112,4
10065,2024-01,140,55,67,18,137,3
10065,2024-02,104,38,57,9,102,2
10065,2024-03,111,43,55,13,110,1
10065,2024-04,141,52,68,21,136,5
10065,2024-05,116,42,60,14,115,1
10065,2024-06,135,50,61,24,131,4
10065,2024-07,150,49,77,24,147,3
10065,2024-08,113,54,45,14,108,5
10065,2024-09,136,52,66,18,130,6
10065,2024-10,120,50,58,12,119,1
10065,2024-11,132,62,53,17,129,3
10065,2024-12,99,43,44,12,99,0
10069,2020-01,17,9,5,3,16,1
10069,2020-02,6,3,2,1,6,0
10069,2020-03,5,3,0,2,5,0
10069,2020-04,10,4,4,2,10,0
10069,2020-05,6,2,2,2,6,0
10069,2020-06,11,4,7,0,11,0
10069,2020-07,12,8,4,0,12,0
10069,2020-08,19,12,5,2,19,0
10069,2020-09,11,6,5,0,11,0
10069,2020-10,11,5,5,1,11,0
10069,2020-11,12,4,6,2,12,0
10069,2020-12,10,6,3,1,9,1
10069,2021-01,16,6,9,1,15,1
10069,2021-02,4,3,0,1,4,0
10069,2021-03,7,1,2,4,7,0
10069,2021-04,12,3,8,1,12,0
10069,2021-05,18,3,9,6,18,0
10069,2021-06,8,2,3,3,7,1
10069,2021-07,10,6,4,0,10,0
10069,2021-08,9,6,3,0,9,0
10069,2021-09,13,7,2,4,13,0
10069,2021-10,19,7,10,2,18,1
10069,2021-11,8,2,2,4,8,0
10069,2021-12,21,9,7,5,21,0
10069,2022-01,10,6,3,1,10,0
10069,2022-02,23,14,3,6,23,0
10069,2022-03,19,6,3,10,19,0
10069,2022-04,13,7,2,4,13,0
10069,2022-05,18,4,9,5,18,0
10069,2022-06,17,9,5,3,17,0
10069,2022-07,11,5,5,1,11,0
10069,2022-08,13,7,4,2,13,0
10069,2022-09,19,6,9,4,19,0
10069,2022-10,16,5,8,3,15,1
10069,2022-11,15,4,5,6,15,0
10069,2022-12,12,4,2,6,12,0
10069,2023-01,17,8,2,7,17,0
10069,2023-02,11,6,2,3,10,1
10069,2023-03,15,7,3,5,15,0
10069,2023-04,16,5,6,5,16,0
10069,2023-05,18,7,3,8,18,0
10069,2023-06,14,5,6,3,14,0
10069,2023-07,18,9,8,1,16,2
10069,2023-08,15,6,7,2,15,0
10069,2023-09,23,10,9,4,23,0
10069,2023-10,13,6,4,3,13,0
10069,2023-11,10,4,1,5,10,0
10069,2023-12,14,6,6,2,14,0
10069,2024-01,7,2,3,2,7,0
10069,2024-02,12,2,7,3,12,0
10069,2024-03,8,1,2,5,8,0
10069,2024-04,12,5,4,3,12,0
10069,2024-05,18,9,4,5,18,0
10069,2024-06,17,8,8,1,17,0
10069,2024-07,17,6,6,5,17,0
10069,2024-08,13,7,4,2,13,0
10069,2024-09,22,9,9,4,21,1
10069,2024-10,16,7,7,2,16,0
10069,2024-11,15,12,2,1,15,0
10069,2024-12,14,6,7,1,14,0
10075,2020-01,75,22,49,4,75,0
10075,2020-02,63,21,31,11,63,0
10075,2020-03,52,10,29,13,52,0
10075,2020-04,49,19,28,2,48,1
10075,2020-05,39,15,17,7,38,1
10075,2020-06,71,21,42,8,71,0
10075,2020-07,70,17,46,7,70,0
10075,2020-08,75,38,34,3,75,0
10075,2020-09,64,14,48,2,64,0
10075,2020-10,71,24,39,8,69,2
10075,2020-11,96,29,59,8,95,1
10075,2020-12,63,13,44,6,62,1
10075,2021-01,81,15,60,6,80,1
10075,2021-02,40,12,23,5,40,0
10075,2021-03,74,14,55,5,74,0
10075,2021-04,89,23,60,6,88,1
10075,2021-05,101,20,70,11,98,3
10075,2021-06,90,13,68,9,88,2
10075,2021-07,91,24,63,4,91,0
10075,2021-08,77,23,49,5,77,0
10075,2021-09,69,25,36,8,68,1
10075,2021-10,80,20,47,13,80,0
10075,2021-11,77,14,56,7,76,1
10075,2021-12,79,21,52,6,79,0
10075,2022-01,85,21,47,17,84,1
10075,2022-02,76,21,51,4,75,1
10075,2022-03,83,25,52,6,76,7
10075,2022-04,67,22,40,5,66,1
10075,2022-05,84,27,48,9,82,2
10075,2022-06,89,28,49,12,86,3
10075,2022-07,77,28,43,6,77,0
10075,2022-08,103,22,73,8,100,3
10075,2022-09,83,28,48,7,82,1
10075,2022-10,69,26,38,5,68,1
10075,2022-11,62,25,31,6,60,2
10075,2022-12,55,21,28,6,53,2
10075,2023-01,70,23,39,8,70,0
10075,2023-02,48,15,29,4,47,1
10075,2023-03,56,27,20,9,56,0
10075,2023-04,56,22,29,5,56,0
10075,2023-05,63,29,31,3,63,0
10075,2023-06,63,26,30,7,63,0
10075,2023-07,58,26,24,8,56,2
10075,2023-08,63,29,20,14,63,0
10075,2023-09,62,20,31,11,62,0
10075,2023-10,54,25,22,7,53,1
10075,2023-11,49,18,23,8,48,1
10075,2023-12,53,21,21,11,52,1
10075,2024-01,59,13,36,10,59,0
10075,2024-02,42,16,23,3,42,0
10075,2024-03,62,21,28,13,61,1
10075,2024-04,45,15,20,10,45,0
10075,2024-05,57,20,29,8,55,2
10075,2024-06,60,26,24,10,60,0
10075,2024-07,61,22,33,6,61,0
10075,2024-08,57,20,32,5,56,1
10075,2024-09,56,24,24,8,56,0
10075,2024-10,65,17,41,7,64,1
10075,2024-11,59,20,34,5,58,1
10075,2024-12,37,16,16,5,37,0
10128,2020-01,205,74,108,23,201,4
10128,2020-02,170,52,87,31,166,4
10128,2020-03,157,50,85,22,156,1
10128,2020-04,117,40,61,16,114,3
10128,2020-05,150,57,77,16,144,6
10128,2020-06,155,51,93,11,153,2
10128,2020-07,166,41,112,13,166,0
10128,2020-08,196,60,103,33,192,4
10128,2020-09,204,84,98,22,199,5
10128,2020-10,191,71,106,14,189,2
10128,2020-11,212,69,120,23,202,10
10128,2020-12,192,59,109,24,184,8
10128,2021-01,161,59,79,23,160,1
10128,2021-02,127,27,87,13,126,1
10128,2021-03,157,59,77,21,155,2
10128,2021-04,120,38,67,15,115,4
10128,2021-05,146,39,89,18,146,0
10128,2021-06,181,59,105,17,179,2
10128,2021-07,186,52,110,24,182,4
10128,2021-08,182,62,95,25,181,1
10128,2021-09,197,68,106,23,195,2
10128,2021-10,198,71,101,26,196,2
10128,2021-11,218,72,122,24,211,7
10128,2021-12,207,57,121,29,204,3
10128,2022-01,217,58,132,27,214,3
10128,2022-02,222,64,135,23,221,1
10128,2022-03,258,73,163,22,253,5
10128,2022-04,253,83,145,25,248,5
10128,2022-05,275,85,159,31,273,2
10128,2022-06,288,75,184,29,283,5
10128,2022-07,264,86,150,28,263,1
10128,2022-08,243,77,138,28,235,8
10128,2022-09,262,83,159,20,257,5
10128,2022-10,261,82,154,25,260,1
10128,2022-11,254,54,175,25,247,7
10128,2022-12,241,64,164,13,236,5
10128,2023-01,243,70,144,29,242,1
10128,2023-02,203,72,113,18,201,2
10128,2023-03,217,75,122,20,214,3
10128,2023-04,205,67,111,27,202,3
10128,2023-05,228,71,132,25,226,2
10128,2023-06,256,84,139,33,252,4
10128,2023-07,215,77,111,27,212,3
10128,2023-08,239,79,128,32,238,1
10128,2023-09,225,71,127,27,225,0
10128,2023-10,210,67,112,31,208,2
10128,2023-11,222,75,121,26,220,2
10128,2023-12,203,67,98,38,202,1
10128,2024-01,210,64,125,21,207,3
10128,2024-02,187,68,93,26,184,3
10128,2024-03,198,63,97,38,195,3
10128,2024-04,184,47,105,32,181,3
10128,2024-05,220,68,124,28,217,3
10128,2024-06,234,84,110,40,233,1
10128,2024-07,233,68,131,34,230,3
10128,2024-08,232,75,126,31,230,2
10128,2024-09,271,81,162,28,265,6
10128,2024-10,271,77,153,41,269,2
10128,2024-11,228,57,149,22,226,2
10128,2024-12,205,62,117,26,202,3
10280,2020-01,16,3,10,3,16,0
10280,2020-02,15,4,10,1,15,0
10280,2020-03,15,5,8,2,15,0
10280,2020-04,8,1,6,1,8,0
10280,2020-05,12,4,8,0,12,0
10280,2020-06,12,4,8,0,12,0
10280,2020-07,12,2,7,3,12,0
10280,2020-08,13,5,5,3,13,0
10280,2020-09,14,7,5,2,14,0
10280,2020-10,10,4,2,4,10,0
10280,2020-11,11,4,6,1,11,0
10280,2020-12,8,3,4,1,7,1
10280,2021-01,8,3,2,3,8,0
10280,2021-02,12,6,6,0,12,0
10280,2021-03,13,3,7,3,13,0
10280,2021-04,19,6,11,2,19,0
10280,2021-05,19,5,12,2,19,0
10280,2021-06,14,5,9,0,14,0
10280,2021-07,16,7,8,1,16,0
10280,2021-08,18,10,6,2,18,0
10280,2021-09,24,12,10,2,24,0
10280,2021-10,16,4,11,1,15,1
10280,2021-11,13,2,11,0,13,0
10280,2021-12,13,5,7,1,13,0
10280,2022-01,18,4,10,4,18,0
10280,2022-02,28,9,15,4,28,0
10280,2022-03,18,7,8,3,17,1
10280,2022-04,17,7,9,1,17,0
10280,2022-05,17,6,11,0,17,0
10280,2022-06,20,7,13,0,20,0
10280,2022-07,14,6,5,3,14,0
10280,2022-08,31,7,18,6,29,2
10280,2022-09,27,12,15,0,27,0
10280,2022-10,24,10,11,3,24,0
10280,2022-11,16,5,7,4,16,0
10280,2022-12,22,7,12,3,22,0
10280,2023-01,13,4,7,2,13,0
10280,2023-02,10,4,6,0,10,0
10280,2023-03,18,9,8,1,18,0
10280,2023-04,21,11,10,0,21,0
10280,2023-05,14,6,6,2,13,1
10280,2023-06,10,4,5,1,10,0
10280,2023-07,30,15,8,7,30,0
10280,2023-08,13,4,7,2,13,0
10280,2023-09,21,15,4,2,20,1
10280,2023-10,21,10,9,2,20,1
10280,2023-11,15,12,2,1,15,0
10280,2023-12,15,5,8,2,15,0
10280,2024-01,15,5,10,0,15,0
10280,2024-02,15,8,5,2,15,0
10280,2024-03,8,5,1,2,8,0
10280,2024-04,17,10,7,0,17,0
10280,2024-05,20,8,8,4,19,1
10280,2024-06,32,7,20,5,31,1
10280,2024-07,10,5,5,0,9,1
10280,2024-08,25,11,13,1,25,0
10280,2024-09,21,10,9,2,21,0
10280,2024-10,9,3,3,3,9,0
10280,2024-11,8,5,2,1,8,0
10280,2024-12,14,6,6,2,14,0
10282,2020-01,10,7,3,0,10,0
10282,2020-02,3,0,2,1,3,0
10282,2020-03,6,1,5,0,6,0
10282,2020-04,5,2,2,1,5,0
10282,2020-05,9,2,7,0,9,0
10282,2020-06,4,1,2,1,4,0
10282,2020-07,8,3,3,2,8,0
10282,2020-08,6,1,3,2,6,0
10282,2020-09,20,4,14,2,20,0
10282,2020-10,19,1,15,3,19,0
10282,2020-11,10,3,7,0,10,0
10282,2020-12,15,3,12,0,15,0
10282,2021-01,10,2,7,1,10,0
10282,2021-02,14,1,13,0,14,0
10282,2021-03,17,2,15,0,17,0
10282,2021-04,7,2,5,0,7,0
10282,2021-05,17,3,13,1,16,1
10282,2021-06,18,5,11,2,18,0
10282,2021-07,9,0,8,1,9,0
10282,2021-08,8,4,3,1,8,0
10282,2021-09,11,1,8,2,11,0
10282,2021-10,6,2,3,1,6,0
10282,2021-11,7,2,4,1,7,0
10282,2021-12,21,4,13,4,21,0
10282,2022-01,8,1,6,1,8,0
10282,2022-02,9,4,2,3,9,0
10282,2022-03,6,2,4,0,6,0
10282,2022-04,13,5,8,0,12,1
10282,2022-05,13,7,4,2,13,0
10282,2022-06,8,2,5,1,8,0
10282,2022-07,17,2,12,3,17,0
10282,2022-08,21,6,15,0,21,0
10282,2022-09,14,4,10,0,13,1
10282,2022-10,13,4,6,3,12,1
10282,2022-11,12,4,6,2,12,0
10282,2022-12,16,4,11,1,16,0
10282,2023-01,11,1,10,0,11,0
10282,2023-02,17,2,15,0,17,0
10282,2023-03,29,9,19,1,29,0
10282,2023-04,10,3,7,0,10,0
10282,2023-05,23,2,18,3,22,1
10282,2023-06,22,10,12,0,22,0
10282,2023-07,20,6,14,0,20,0
10282,2023-08,11,4,7,0,10,1
10282,2023-09,12,3,6,3,12,0
10282,2023-10,11,5,6,0,11,0
10282,2023-11,38,8,28,2,38,0
10282,2023-12,14,2,12,0,13,1
10282,2024-01,37,1,36,0,37,0
10282,2024-02,46,5,40,1,46,0
10282,2024-03,21,2,17,2,21,0
10282,2024-04,26,4,22,0,26,0
10282,2024-05,20,4,15,1,20,0
10282,2024-06,17,2,14,1,17,0
10282,2024-07,24,9,15,0,24,0
10282,2024-08,31,3,27,1,31,0
10282,2024-09,28,1,24,3,28,0
10282,2024-10,21,4,15,2,21,0
10282,2024-11,25,3,20,2,25,0
10282,2024-12,14,6,7,1,14,0
10301,2020-01,249,58,149,42,247,2
10301,2020-02,198,58,110,30,195,3
10301,2020-03,218,46,140,32,216,2
10301,2020-04,114,27,67,20,113,1
10301,2020-05,136,41,68,27,134,2
10301,2020-06,151,35,66,50,151,0
10301,2020-07,173,47,77,49,170,3
10301,2020-08,184,59,81,44,182,2
10301,2020-09,169,39,93,37,167,2
10301,2020-10,204,61,95,48,202,2
10301,2020-11,173,36,97,40,172,1
10301,2020-12,161,59,66,36,159,2
10301,2021-01,165,47,95,23,162,3
10301,2021-02,151,53,61,37,148,3
10301,2021-03,203,67,103,33,200,2
10301,2021-04,166,42,96,28,163,3
10301,2021-05,190,58,98,34,186,4
10301,2021-06,215,55,119,41,212,3
10301,2021-07,224,40,141,43,221,3
10301,2021-08,198,47,86,65,196,2
10301,2021-09,224,67,107,50,222,2
10301,2021-10,254,75,127,52,252,2
10301,2021-11,244,62,139,43,239,5
10301,2021-12,227,59,117,51,227,0
10301,2022-01,208,65,95,48,206,2
10301,2022-02,188,41,97,50,185,3
10301,2022-03,220,59,122,39,217,3
10301,2022-04,263,60,139,64,260,3
10301,2022-05,279,74,124,81,278,1
10301,2022-06,316,80,183,53,313,3
10301,2022-07,289,68,176,45,286,3
10301,2022-08,319,90,167,62,314,5
10301,2022-09,292,86,147,59,290,2
10301,2022-10,269,76,139,54,267,2
10301,2022-11,321,90,170,61,318,3
10301,2022-12,293,88,157,48,291,2
10301,2023-01,322,74,182,66,320,2
10301,2023-02,268,79,147,42,261,7
10301,2023-03,308,94,163,51,306,2
10301,2023-04,275,84,133,58,274,1
10301,2023-05,329,106,168,55,327,2
10301,2023-06,324,99,164,61,323,1
10301,2023-07,325,92,179,54,322,3
10301,2023-08,287,76,147,64,277,10
10301,2023-09,309,85,159,65,305,4
10301,2023-10,331,84,186,61,330,1
10301,2023-11,353,94,204,55,350,3
10301,2023-12,345,89,205,51,340,5
10301,2024-01,321,69,193,59,319,2
10301,2024-02,306,76,182,48,304,2
10301,2024-03,358,81,205,72,354,4
10301,2024-04,319,83,175,61,315,4
10301,2024-05,329,84,173,72,324,5
10301,2024-06,290,84,155,51,288,2
10301,2024-07,301,84,155,62,298,3
10301,2024-08,294,77,155,62,291,3
10301,2024-09,350,86,197,67,345,5
10301,2024-10,334,91,187,56,326,8
10301,2024-11,275,59,145,71,273,2
10301,2024-12,269,67,148,54,267,2
10302,2020-01,100,24,61,15,99,1
10302,2020-02,108,19,71,18,108,0
10302,2020-03,89,25,48,16,88,1
10302,2020-04,63,18,33,12,63,0
10302,2020-05,87,20,51,16,85,2
10302,2020-06,86,28,34,24,82,4
10302,2020-07,75,22,42,11,74,1
10302,2020-08,96,43,35,18,93,3
10302,2020-09,89,27,47,15,88,1
10302,2020-10,116,42,49,25,116,0
10302,2020-11,100,26,59,15,100,0
10302,2020-12,105,25,62,18,104,1
10302,2021-01,83,19,45,19,81,2
10302,2021-02,91,25,42,24,88,3
10302,2021-03,76,24,36,16,76,0
10302,2021-04,99,22,58,19,99,0
10302,2021-05,122,29,58,35,122,0
10302,2021-06,122,30,67,25,122,0
10302,2021-07,111,25,65,21,111,0
10302,2021-08,102,29,49,24,100,2
10302,2021-09,109,34,52,23,109,0
10302,2021-10,129,34,66,29,128,1
10302,2021-11,108,24,62,22,106,2
10302,2021-12,123,46,68,9,123,0
10302,2022-01,87,18,48,21,85,2
10302,2022-02,113,30,63,20,113,0
10302,2022-03,120,35,63,22,118,2
10302,2022-04,130,24,85,21,130,0
10302,2022-05,120,32,59,29,119,1
10302,2022-06,132,28,80,24,131,1
10302,2022-07,128,24,75,29,128,0
10302,2022-08,120,30,68,22,120,0
10302,2022-09,117,30,65,22,117,0
10302,2022-10,124,33,60,31,122,2
10302,2022-11,137,33,76,28,136,1
10302,2022-12,119,29,68,22,118,1
10302,2023-01,126,27,69,30,126,0
10302,2023-02,115,21,70,24,111,4
10302,2023-03,126,33,63,30,126,0
10302,2023-04,135,39,72,24,135,0
10302,2023-05,159,33,90,36,157,2
10302,2023-06,129,34,74,21,125,4
10302,2023-07,134,33,74,27,131,3
10302,2023-08,164,35,88,41,161,3
10302,2023-09,146,37,80,29,145,1
10302,2023-10,160,50,80,30,159,1
10302,2023-11,136,30,73,33,136,0
10302,2023-12,121,25,61,35,121,0
10302,2024-01,133,39,75,19,132,1
10302,2024-02,135,34,77,24,135,0
10302,2024-03,132,29,77,26,128,4
10302,2024-04,130,34,69,27,130,0
10302,2024-05,157,35,90,32,157,0
10302,2024-06,150,33,87,30,148,2
10302,2024-07,160,47,84,29,159,1
10302,2024-08,137,37,79,21,133,4
10302,2024-09,179,51,104,24,178,1
10302,2024-10,150,36,95,19,149,1
10302,2024-11,112,24,70,18,110,2
10302,2024-12,139,35,80,24,137,2
10303,2020-01,139,32,82,25,138,1
10303,2020-02,119,30,68,21,117,2
10303,2020-03,150,50,79,21,148,2
10303,2020-04,126,41,63,22,125,1
10303,2020-05,124,29,63,32,124,0
10303,2020-06,128,30,66,32,127,1
10303,2020-07,133,36,63,34,130,3
10303,2020-08,152,36,83,33,150,2
10303,2020-09,160,46,85,29,157,3
10303,2020-10,161,41,102,18,157,4
10303,2020-11,126,36,65,25,124,2
10303,2020-12,143,51,66,26,143,0
10303,2021-01,145,38,81,26,145,0
10303,2021-02,133,34,71,28,132,1
10303,2021-03,150,40,84,26,148,2
10303,2021-04,134,41,58,35,131,3
10303,2021-05,158,47,81,30,156,2
10303,2021-06,151,48,69,34,148,3
10303,2021-07,166,57,82,27,163,3
10303,2021-08,124,29,68,27,122,2
10303,2021-09,161,41,89,31,161,0
10303,2021-10,149,38,82,29,148,1
10303,2021-11,146,40,70,36,144,2
10303,2021-12,148,43,81,24,146,2
10303,2022-01,124,41,57,26,123,1
10303,2022-02,124,43,58,23,121,3
10303,2022-03,169,45,80,44,167,2
10303,2022-04,174,44,88,42,174,0
10303,2022-05,171,53,85,33,171,0
10303,2022-06,165,40,77,48,164,1
10303,2022-07,187,38,98,51,187,0
10303,2022-08,184,53,95,36,182,2
10303,2022-09,141,31,75,35,140,1
10303,2022-10,167,47,90,30,167,0
10303,2022-11,128,31,64,33,128,0
10303,2022-12,161,35,85,41,157,4
10303,2023-01,155,36,75,44,153,2
10303,2023-02,126,28,75,23,125,1
10303,2023-03,163,42,89,32,163,0
10303,2023-04,167,47,96,24,167,0
10303,2023-05,192,39,120,33,192,0
10303,2023-06,166,59,82,25,165,1
10303,2023-07,188,43,104,41,186,2
10303,2023-08,201,51,107,43,198,3
10303,2023-09,145,48,74,23,143,2
10303,2023-10,176,61,80,35,175,1
10303,2023-11,164,46,90,28,162,2
10303,2023-12,180,50,102,28,177,3
10303,2024-01,182,44,100,38,182,0
10303,2024-02,153,41,84,28,153,0
10303,2024-03,171,45,96,30,167,4
10303,2024-04,164,37,91,36,163,1
10303,2024-05,165,37,88,40,164,1
10303,2024-06,138,35,75,28,138,0
10303,2024-07,137,39,66,32,136,1
10303,2024-08,169,44,82,43,166,3
10303,2024-09,145,47,60,38,145,0
10303,2024-10,154,29,82,43,153,1
10303,2024-11,170,28,97,45,169,1
10303,2024-12,141,37,79,25,140,1
10304,2020-01,204,60,102,42,203,1
10304,2020-02,204,64,99,41,200,4
10304,2020-03,167,47,86,34,166,1
10304,2020-04,163,36,76,51,161,2
10304,2020-05,190,53,97,40,188,2
10304,2020-06,174,49,72,53,172,2
10304,2020-07,204,54,103,47,202,2
10304,2020-08,250,74,121,55,248,2
10304,2020-09,237,59,117,61,235,2
10304,2020-10,218,61,116,41,218,0
10304,2020-11,193,54,92,47,190,3
10304,2020-12,178,63,86,29,176,2
10304,2021-01,191,53,92,46,190,1
10304,2021-02,167,64,72,31,164,3
10304,2021-03,209,52,110,47,208,1
10304,2021-04,193,55,106,32,193,0
10304,2021-05,197,61,94,42,196,1
10304,2021-06,241,74,124,43,239,2
10304,2021-07,250,58,136,56,245,5
10304,2021-08,223,73,101,49,221,2
10304,2021-09,242,74,109,59,242,0
10304,2021-10,248,69,126,53,244,4
10304,2021-11,192,50,101,41,191,1
10304,2021-12,244,76,122,46,238,6
10304,2022-01,210,68,88,54,208,2
10304,2022-02,211,40,119,52,208,3
10304,2022-03,256,66,124,66,251,5
10304,2022-04,224,51,130,43,222,2
10304,2022-05,230,64,110,56,226,4
10304,2022-06,242,85,104,53,237,5
10304,2022-07,267,70,131,66,265,2
10304,2022-08,308,81,147,80,307,1
10304,2022-09,286,85,149,52,282,4
10304,2022-10,278,66,156,56,275,3
10304,2022-11,293,82,144,67,291,2
10304,2022-12,252,63,129,60,249,3
10304,2023-01,268,80,135,53,265,3
10304,2023-02,237,74,125,38,236,1
10304,2023-03,323,95,162,66,320,3
10304,2023-04,296,81,151,64,292,4
10304,2023-05,326,76,173,77,323,3
10304,2023-06,354,95,195,64,352,2
10304,2023-07,350,117,174,59,345,5
10304,2023-08,371,110,195,66,365,6
10304,2023-09,318,102,167,49,313,5
10304,2023-10,343,97,187,59,340,3
10304,2023-11,303,81,174,48,299,4
10304,2023-12,273,84,147,42,271,2
10304,2024-01,305,81,183,41,303,2
10304,2024-02,311,94,167,50,308,3
10304,2024-03,333,105,161,67,328,5
10304,2024-04,301,85,161,55,299,2
10304,2024-05,301,90,146,65,297,4
10304,2024-06,316,88,164,64,316,0
10304,2024-07,318,92,161,65,314,4
10304,2024-08,325,103,159,63,322,3
10304,2024-09,278,75,152,51,274,4
10304,2024-10,293,80,168,45,288,5
10304,2024-11,304,77,165,62,303,1
10304,2024-12,283,82,141,60,279,4
10305,2020-01,145,40,81,24,143,2
10305,2020-02,143,33,78,32,139,4
10305,2020-03,119,31,59,29,117,2
10305,2020-04,111,26,65,20,105,6
10305,2020-05,99,25,50,24,98,1
10305,2020-06,126,37,59,30,126,0
10305,2020-07,151,31,85,35,151,0
10305,2020-08,168,44,88,36,163,5
10305,2020-09,127,32,57,38,124,3
10305,2020-10,138,34,71,33,138,0
10305,2020-11,117,40,49,28,116,1
10305,2020-12,93,29,42,22,93,0
10305,2021-01,117,37,56,24,115,2
10305,2021-02,99,27,38,34,98,1
10305,2021-03,113,32,56,25,112,1
10305,2021-04,134,26,70,38,133,1
10305,2021-05,124,38,54,32,123,1
10305,2021-06,151,31,76,44,150,1
10305,2021-07,141,42,61,38,138,3
10305,2021-08,139,35,63,41,137,2
10305,2021-09,136,35,69,32,134,2
10305,2021-10,130,40,60,30,129,1
10305,2021-11,137,29,70,38,136,1
10305,2021-12,128,33,59,36,125,3
10305,2022-01,111,28,53,30,111,0
10305,2022-02,116,38,51,27,114,2
10305,2022-03,151,37,77,37,150,1
10305,2022-04,141,45,70,26,139,2
10305,2022-05,132,34,71,27,131,1
10305,2022-06,161,45,75,41,161,0
10305,2022-07,153,38,84,31,150,3
10305,2022-08,183,35,107,41,181,2
10305,2022-09,157,45,85,27,155,2
10305,2022-10,179,39,105,35,179,0
10305,2022-11,171,47,95,29,168,3
10305,2022-12,160,47,87,26,160,0
10305,2023-01,168,61,72,35,167,1
10305,2023-02,138,38,67,33,136,2
10305,2023-03,191,39,120,32,189,2
10305,2023-04,190,63,86,41,188,2
10305,2023-05,197,54,99,44,196,1
10305,2023-06,182,50,103,29,181,1
10305,2023-07,193,62,101,30,191,2
10305,2023-08,185,47,90,48,182,3
10305,2023-09,146,37,65,44,144,2
10305,2023-10,179,47,105,27,176,3
10305,2023-11,169,41,100,28,167,2
10305,2023-12,134,34,73,27,133,1
10305,2024-01,153,38,83,32,153,0
10305,2024-02,148,36,88,24,147,1
10305,2024-03,154,49,77,28,153,1
10305,2024-04,173,46,97,30,172,1
10305,2024-05,194,52,113,29,187,7
10305,2024-06,201,51,108,42,200,1
10305,2024-07,204,52,106,46,203,1
10305,2024-08,144,32,83,29,144,0
10305,2024-09,159,40,81,38,159,0
10305,2024-10,150,39,80,31,147,3
10305,2024-11,135,42,59,34,133,2
10305,2024-12,132,32,75,25,132,0
10306,2020-01,166,25,95,46,160,6
10306,2020-02,173,44,84,45,172,1
10306,2020-03,173,42,101,30,171,2
10306,2020-04,125,23,77,25,122,3
10306,2020-05,148,34,81,33,145,3
10306,2020-06,150,24,83,43,149,1
10306,2020-07,143,30,71,42,140,3
10306,2020-08,151,32,79,40,147,4
10306,2020-09,170,34,99,37,170,0
10306,2020-10,151,43,70,38,148,3
10306,2020-11,156,40,77,39,155,1
10306,2020-12,135,41,63,31,132,3
10306,2021-01,199,49,117,33,198,1
10306,2021-02,112,28,52,32,112,0
10306,2021-03,164,38,83,43,162,2
10306,2021-04,151,36,81,34,150,1
10306,2021-05,158,47,73,38,154,4
10306,2021-06,176,45,74,57,174,2
10306,2021-07,138,42,62,34,135,3
10306,2021-08,159,44,78,37,157,2
10306,2021-09,172,41,85,46,172,0
10306,2021-10,179,41,90,48,174,5
10306,2021-11,166,51,80,35,162,4
10306,2021-12,163,51,73,39,163,0
10306,2022-01,165,51,83,31,165,0
10306,2022-02,147,41,81,25,145,2
10306,2022-03,185,47,105,33,183,2
10306,2022-04,158,40,86,32,154,4
10306,2022-05,193,36,123,34,192,1
10306,2022-06,212,44,115,53,210,2
10306,2022-07,227,52,127,48,226,1
10306,2022-08,183,51,93,39,177,6
10306,2022-09,246,53,141,52,243,3
10306,2022-10,223,58,123,42,222,1
10306,2022-11,206,53,109,44,203,3
10306,2022-12,218,59,130,29,214,4
10306,2023-01,208,52,130,26,204,4
10306,2023-02,170,43,97,30,168,2
10306,2023-03,212,47,127,38,206,6
10306,2023-04,201,51,105,45,197,4
10306,2023-05,219,56,114,49,217,2
10306,2023-06,222,59,110,53,220,2
10306,2023-07,196,48,109,39,192,4
10306,2023-08,161,47,85,29,158,3
10306,2023-09,160,48,77,35,159,1
10306,2023-10,184,52,95,37,182,2
10306,2023-11,208,59,112,37,200,8
10306,2023-12,193,55,98,40,191,2
10306,2024-01,173,62,81,30,168,5
10306,2024-02,199,52,105,42,197,2
10306,2024-03,206,61,100,45,206,0
10306,2024-04,175,46,94,35,174,1
10306,2024-05,183,47,96,40,181,2
10306,2024-06,187,42,97,48,185,2
10306,2024-07,158,45,88,25,156,2
10306,2024-08,192,56,94,42,188,4
10306,2024-09,196,56,92,48,196,0
10306,2024-10,171,43,88,40,171,0
10306,2024-11,135,43,70,22,134,1
10306,2024-12,145,35,73,37,144,1
10307,2020-01,28,10,16,2,28,0
10307,2020-02,22,6,12,4,22,0
10307,2020-03,28,8,15,5,28,0
10307,2020-04,23,5,14,4,22,1
10307,2020-05,23,4,14,5,23,0
10307,2020-06,24,12,8,4,24,0
10307,2020-07,27,11,12,4,27,0
10307,2020-08,31,11,12,8,31,0
10307,2020-09,37,10,18,9,36,1
10307,2020-10,18,6,10,2,18,0
10307,2020-11,33,12,17,4,33,0
10307,2020-12,30,8,15,7,30,0
10307,2021-01,19,5,9,5,19,0
10307,2021-02,22,6,11,5,21,1
10307,2021-03,41,10,25,6,40,1
10307,2021-04,41,9,23,9,40,1
10307,2021-05,25,5,17,3,25,0
10307,2021-06,34,6,22,6,33,1
10307,2021-07,31,6,14,11,31,0
10307,2021-08,22,3,14,5,20,2
10307,2021-09,33,5,24,4,32,1
10307,2021-10,33,11,14,8,33,0
10307,2021-11,43,12,22,9,43,0
10307,2021-12,36,12,19,5,36,0
10307,2022-01,33,9,19,5,33,0
10307,2022-02,31,14,12,5,31,0
10307,2022-03,33,6,19,8,33,0
10307,2022-04,33,14,16,3,33,0
10307,2022-05,34,9,15,10,32,2
10307,2022-06,41,8,16,17,39,2
10307,2022-07,33,14,15,4,32,1
10307,2022-08,25,5,15,5,25,0
10307,2022-09,30,9,16,5,29,1
10307,2022-10,47,13,26,8,46,1
10307,2022-11,40,8,27,5,36,4
10307,2022-12,52,21,20,11,52,0
10307,2023-01,39,6,23,10,37,2
10307,2023-02,35,7,17,11,35,0
10307,2023-03,44,17,20,7,43,1
10307,2023-04,26,7,14,5,25,1
10307,2023-05,41,10,23,8,39,2
10307,2023-06,42,10,22,10,42,0
10307,2023-07,39,17,16,6,39,0
10307,2023-08,32,9,20,3,32,0
10307,2023-09,32,8,20,4,31,1
10307,2023-10,43,12,16,15,43,0
10307,2023-11,26,11,12,3,26,0
10307,2023-12,43,6,23,14,41,2
10307,2024-01,33,7,18,8,33,0
10307,2024-02,37,7,21,9,37,0
10307,2024-03,23,10,9,4,22,1
10307,2024-04,24,6,11,7,24,0
10307,2024-05,42,6,23,13,42,0
10307,2024-06,42,16,15,11,40,2
10307,2024-07,36,11,20,5,35,1
10307,2024-08,36,11,13,12,36,0
10307,2024-09,32,12,15,5,31,1
10307,2024-10,33,10,15,8,33,0
10307,2024-11,40,7,17,16,40,0
10307,2024-12,35,9,18,8,35,0
10308,2020-01,58,16,31,11,57,1
10308,2020-02,41,11,20,10,41,0
10308,2020-03,34,4,17,13,34,0
10308,2020-04,40,8,19,13,40,0
10308,2020-05,63,18,33,12,61,2
10308,2020-06,44,12,23,9,43,1
10308,2020-07,44,14,20,10,43,1
10308,2020-08,47,17,14,16,46,1
10308,2020-09,36,14,12,10,36,0
10308,2020-10,50,11,25,14,50,0
10308,2020-11,44,12,23,9,44,0
10308,2020-12,49,19,20,10,48,1
10308,2021-01,48,12,28,8,48,0
10308,2021-02,45,15,20,10,45,0
10308,2021-03,42,11,23,8,42,0
10308,2021-04,47,8,26,13,47,0
10308,2021-05,42,5,16,21,42,0
10308,2021-06,47,9,18,20,46,1
10308,2021-07,43,11,21,11,42,1
10308,2021-08,48,14,16,18,48,0
10308,2021-09,42,9,19,14,41,1
10308,2021-10,70,15,33,22,70,0
10308,2021-11,58,13,22,23,58,0
10308,2021-12,51,10,27,14,51,0
10308,2022-01,42,12,15,15,42,0
10308,2022-02,39,7,22,10,39,0
10308,2022-03,63,11,34,18,63,0
10308,2022-04,73,18,36,19,73,0
10308,2022-05,65,17,28,20,65,0
10308,2022-06,39,10,7,22,39,0
10308,2022-07,59,16,35,8,59,0
10308,2022-08,52,8,33,11,52,0
10308,2022-09,69,20,33,16,69,0
10308,2022-10,59,23,22,14,58,1
10308,2022-11,45,10,21,14,44,1
10308,2022-12,44,11,21,12,43,1
10308,2023-01,50,11,24,15,50,0
10308,2023-02,44,12,20,12,42,2
10308,2023-03,46,13,21,12,44,2
10308,2023-04,60,17,19,24,60,0
10308,2023-05,56,15,26,15,55,1
10308,2023-06,61,16,28,17,60,1
10308,2023-07,78,22,36,20,76,2
10308,2023-08,44,12,17,15,44,0
10308,2023-09,53,19,23,11,52,1
10308,2023-10,58,15,29,14,56,2
10308,2023-11,55,13,29,13,55,0
10308,2023-12,53,15,28,10,52,1
10308,2024-01,50,19,17,14,49,1
10308,2024-02,50,15,28,7,50,0
10308,2024-03,50,18,22,10,50,0
10308,2024-04,52,8,34,10,52,0
10308,2024-05,68,16,37,15,66,2
10308,2024-06,49,17,22,10,49,0
10308,2024-07,59,12,31,16,57,2
10308,2024-08,61,15,31,15,61,0
10308,2024-09,72,25,34,13,72,0
10308,2024-10,48,11,20,17,46,2
10308,2024-11,43,10,22,11,43,0
10308,2024-12,28,8,14,6,28,0
10309,2020-01,63,19,38,6,63,0
10309,2020-02,61,12,33,16,61,0
10309,2020-03,58,16,26,16,58,0
10309,2020-04,61,19,32,10,59,2
10309,2020-05,60,15,30,15,60,0
10309,2020-06,63,14,31,18,62,1
10309,2020-07,76,24,39,13,76,0
10309,2020-08,69,20,30,19,69,0
10309,2020-09,71,17,35,19,69,2
10309,2020-10,57,18,29,10,57,0
10309,2020-11,58,22,25,11,56,2
10309,2020-12,62,15,32,15,60,2
10309,2021-01,72,16,48,8,72,0
10309,2021-02,55,12,27,16,54,1
10309,2021-03,77,25,37,15,76,1
10309,2021-04,73,26,40,7,73,0
10309,2021-05,76,22,45,9,76,0
10309,2021-06,87,21,46,20,87,0
10309,2021-07,77,23,41,13,77,0
10309,2021-08,79,17,41,21,79,0
10309,2021-09,87,26,42,19,86,1
10309,2021-10,68,14,32,22,68,0
10309,2021-11,84,35,40,9,81,3
10309,2021-12,92,30,38,24,92,0
10309,2022-01,78,26,33,19,78,0
10309,2022-02,75,24,45,6,75,0
10309,2022-03,88,21,53,14,88,0
10309,2022-04,85,29,36,20,85,0
10309,2022-05,99,26,47,26,97,2
10309,2022-06,95,33,40,22,94,1
10309,2022-07,86,29,35,22,86,0
10309,2022-08,107,32,56,19,106,1
10309,2022-09,107,27,54,26,106,1
10309,2022-10,114,27,74,13,110,4
10309,2022-11,119,28,71,20,115,4
10309,2022-12,121,29,65,27,118,3
10309,2023-01,106,37,55,14,100,6
10309,2023-02,105,29,65,11,103,2
10309,2023-03,109,29,69,11,106,3
10309,2023-04,115,29,59,27,110,5
10309,2023-05,116,32,58,26,113,3
10309,2023-06,94,27,44,23,93,1
10309,2023-07,70,20,35,15,70,0
10309,2023-08,93,23,54,16,93,0
10309,2023-09,78,20,47,11,74,4
10309,2023-10,101,28,56,17,99,2
10309,2023-11,107,20,67,20,103,4
10309,2023-12,110,34,61,15,108,2
10309,2024-01,81,21,49,11,80,1
10309,2024-02,102,18,60,24,101,1
10309,2024-03,106,26,59,21,104,2
10309,2024-04,104,28,57,19,103,1
10309,2024-05,103,27,47,29,101,2
10309,2024-06,103,31,51,21,101,2
10309,2024-07,81,21,38,22,80,1
10309,2024-08,66,24,28,14,66,0
10309,2024-09,80,26,38,16,79,1
10309,2024-10,80,21,41,18,79,1
10309,2024-11,83,20,45,18,82,1
10309,2024-12,72,18,43,11,72,0
10310,2020-01,115,28,66,21,115,0
10310,2020-02,111,28,60,23,109,2
10310,2020-03,96,19,53,24,96,0
10310,2020-04,71,20,37,14,71,0
10310,2020-05,80,22,47,11,79,1
10310,2020-06,90,26,54,10,89,1
10310,2020-07,97,25,44,28,97,0
10310,2020-08,83,17,42,24,82,1
10310,2020-09,93,24,49,20,90,3
10310,2020-10,81,24,32,25,79,2
10310,2020-11,110,27,60,23,109,1
10310,2020-12,102,35,51,16,101,1
10310,2021-01,90,27,51,12,90,0
10310,2021-02,97,34,38,25,95,2
10310,2021-03,99,37,45,17,97,2
10310,2021-04,98,30,41,27,98,0
10310,2021-05,118,38,59,21,117,1
10310,2021-06,123,42,57,24,121,2
10310,2021-07,119,36,53,30,119,0
10310,2021-08,109,35,47,27,108,1
10310,2021-09,124,42,54,28,122,2
10310,2021-10,99,27,43,29,98,1
10310,2021-11,103,23,55,25,102,1
10310,2021-12,110,35,52,23,108,2
10310,2022-01,115,36,48,31,113,2
10310,2022-02,94,27,46,21,91,3
10310,2022-03,146,38,72,36,145,1
10310,2022-04,96,24,53,19,96,0
10310,2022-05,118,29,59,30,118,0
10310,2022-06,92,24,44,24,92,0
10310,2022-07,179,43,97,39,178,1
10310,2022-08,114,29,64,21,112,2
10310,2022-09,106,38,51,17,104,2
10310,2022-10,119,37,59,23,119,0
10310,2022-11,114,34,54,26,112,2
10310,2022-12,99,24,54,21,98,1
10310,2023-01,140,52,59,29,139,1
10310,2023-02,124,27,66,31,124,0
10310,2023-03,107,38,52,17,107,0
10310,2023-04,109,45,46,18,109,0
10310,2023-05,122,41,62,19,119,3
10310,2023-06,144,43,71,30,143,1
10310,2023-07,133,49,57,27,131,2
10310,2023-08,150,47,80,23,147,3
10310,2023-09,139,38,67,34,138,1
10310,2023-10,145,49,71,25,143,2
10310,2023-11,104,32,49,23,104,0
10310,2023-12,113,26,69,18,112,1
10310,2024-01,113,30,60,23,112,1
10310,2024-02,116,34,60,22,114,2
10310,2024-03,126,36,65,25,122,4
10310,2024-04,130,34,66,30,127,3
10310,2024-05,141,33,83,25,141,0
10310,2024-06,167,66,79,22,161,6
10310,2024-07,176,38,111,27,175,1
10310,2024-08,155,47,73,35,152,3
10310,2024-09,119,40,54,25,119,0
10310,2024-10,139,42,73,24,137,2
10310,2024-11,116,35,55,26,115,1
10310,2024-12,117,28,63,26,115,2
10312,2020-01,94,19,50,25,93,1
10312,2020-02,101,21,55,25,99,2
10312,2020-03,93,23,44,26,93,0
10312,2020-04,122,30,76,16,121,1
10312,2020-05,94,26,47,21,93,1
10312,2020-06,104,28,50,26,99,5
10312,2020-07,97,25,54,18,97,0
10312,2020-08,102,35,51,16,100,2
10312,2020-09,98,23,47,28,96,2
10312,2020-10,115,29,62,24,115,0
10312,2020-11,84,23,48,13,82,2
10312,2020-12,74,29,26,19,74,0
10312,2021-01,111,36,56,19,109,2
10312,2021-02,85,33,35,17,83,2
10312,2021-03,116,32,62,22,113,3
10312,2021-04,93,33,42,18,89,4
10312,2021-05,122,32,60,30,120,2
10312,2021-06,110,23,56,31,110,0
10312,2021-07,102,27,56,19,101,1
10312,2021-08,84,23,37,24,82,2
10312,2021-09,94,24,50,20,92,2
10312,2021-10,91,32,40,19,89,2
10312,2021-11,98,34,48,16,97,1
10312,2021-12,129,42,55,32,128,1
10312,2022-01,89,25,40,24,89,0
10312,2022-02,98,27,52,19,97,1
10312,2022-03,92,26,44,22,91,1
10312,2022-04,115,23,66,26,115,0
10312,2022-05,114,36,51,27,113,1
10312,2022-06,134,34,69,31,133,1
10312,2022-07,114,34,61,19,113,1
10312,2022-08,128,32,76,20,125,3
10312,2022-09,128,30,67,31,124,4
10312,2022-10,131,40,66,25,126,5
10312,2022-11,144,41,71,32,138,6
10312,2022-12,111,35,54,22,107,4
10312,2023-01,103,30,53,20,100,3
10312,2023-02,118,36,54,28,114,4
10312,2023-03,132,36,67,29,132,0
10312,2023-04,128,32,64,32,125,3
10312,2023-05,139,34,70,35,136,3
10312,2023-06,135,45,65,25,129,6
10312,2023-07,158,42,87,29,156,2
10312,2023-08,106,28,50,28,105,1
10312,2023-09,112,27,55,30,111,1
10312,2023-10,135,36,76,23,134,1
10312,2023-11,141,48,63,30,139,2
10312,2023-12,141,30,85,26,141,0
10312,2024-01,121,36,58,27,118,3
10312,2024-02,122,41,60,21,119,3
10312,2024-03,152,58,66,28,150,2
10312,2024-04,136,38,62,36,134,2
10312,2024-05,142,35,76,31,142,0
10312,2024-06,133,47,59,27,131,2
10312,2024-07,118,35,59,24,115,3
10312,2024-08,107,29,53,25,107,0
10312,2024-09,116,24,62,30,116,0
10312,2024-10,154,32,81,41,153,1
10312,2024-11,116,37,55,24,112,4
10312,2024-12,92,27,43,22,91,1
10314,2020-01,274,58,172,44,269,5
10314,2020-02,212,49,124,39,210,2
10314,2020-03,182,37,103,42,181,1
10314,2020-04,151,51,84,16,147,4
10314,2020-05,186,49,89,48,183,3
10314,2020-06,207,67,84,56,203,4
10314,2020-07,193,43,99,51,191,2
10314,2020-08,177,50,92,35,173,4
10314,2020-09,213,58,108,47,213,0
10314,2020-10,231,63,114,54,228,3
10314,2020-11,236,64,133,39,233,3
10314,2020-12,258,75,147,36,254,4
10314,2021-01,232,75,110,47,230,2
10314,2021-02,204,51,105,48,202,2
10314,2021-03,241,70,114,57,239,2
10314,2021-04,239,71,122,46,238,1
10314,2021-05,238,44,116,78,236,2
10314,2021-06,221,54,116,51,220,1
10314,2021-07,243,62,121,60,241,2
10314,2021-08,243,46,138,59,242,1
10314,2021-09,250,61,143,46,250,0
10314,2021-10,315,72,168,75,313,2
10314,2021-11,252,63,146,43,250,2
10314,2021-12,277,81,157,39,276,1
10314,2022-01,283,76,151,56,282,1
10314,2022-02,280,75,158,47,276,4
10314,2022-03,289,85,142,62,286,3
10314,2022-04,285,73,149,63,284,1
10314,2022-05,308,74,170,64,303,5
10314,2022-06,320,62,191,67,316,4
10314,2022-07,315,86,169,60,313,2
10314,2022-08,320,78,191,51,316,4
10314,2022-09,318,81,175,62,317,1
10314,2022-10,317,86,163,68,315,2
10314,2022-11,336,91,183,62,331,5
10314,2022-12,305,72,186,47,298,7
10314,2023-01,320,76,195,49,316,4
10314,2023-02,235,55,129,51,233,2
10314,2023-03,289,76,148,65,286,3
10314,2023-04,304,72,176,56,302,2
10314,2023-05,316,86,173,57,314,2
10314,2023-06,298,72,182,44,297,1
10314,2023-07,314,79,192,43,311,3
10314,2023-08,316,86,175,55,310,6
10314,2023-09,298,87,174,37,297,1
10314,2023-10,368,81,219,68,364,4
10314,2023-11,316,75,174,67,315,1
10314,2023-12,303,73,173,57,302,1
10314,2024-01,329,61,208,60,327,2
10314,2024-02,309,61,178,70,308,1
10314,2024-03,331,77,197,57,324,7
10314,2024-04,299,89,150,60,296,3
10314,2024-05,318,84,159,75,309,9
10314,2024-06,308,87,157,64,307,1
10314,2024-07,293,76,154,63,291,2
10314,2024-08,269,60,153,56,265,4
10314,2024-09,296,53,160,83,289,7
10314,2024-10,327,78,169,80,323,4
10314,2024-11,305,65,178,62,304,1
10314,2024-12,296,58,188,50,296,0
10451,2020-01,541,134,320,87,535,6
10451,2020-02,464,125,246,93,454,10
10451,2020-03,416,112,231,73,414,2
10451,2020-04,323,101,162,60,311,12
10451,2020-05,455,110,271,74,447,8
10451,2020-06,397,125,194,78,395,2
10451,2020-07,400,123,203,74,391,9
10451,2020-08,443,142,219,82,435,8
10451,2020-09,429,173,190,66,421,8
10451,2020-10,476,167,234,75,469,7
10451,2020-11,490,180,235,75,482,8
10451,2020-12,416,124,226,66,412,4
10451,2021-01,426,147,219,60,416,10
10451,2021-02,318,88,191,39,314,4
10451,2021-03,417,106,253,58,412,5
10451,2021-04,365,125,166,74,362,3
10451,2021-05,398,123,208,67,392,6
10451,2021-06,421,146,189,86,415,6
10451,2021-07,468,149,235,84,462,6
10451,2021-08,447,155,212,80,436,11
10451,2021-09,439,158,197,84,434,5
10451,2021-10,532,173,268,91,523,9
10451,2021-11,437,147,213,77,427,10
10451,2021-12,444,152,209,83,436,8
10451,2022-01,422,138,193,91,415,7
10451,2022-02,442,144,233,65,437,5
10451,2022-03,558,193,292,73,546,12
10451,2022-04,507,164,246,97,500,7
10451,2022-05,477,152,249,76,473,4
10451,2022-06,560,201,279,80,544,16
10451,2022-07,520,203,256,61,509,11
10451,2022-08,580,205,294,81,570,10
10451,2022-09,539,180,287,72,529,10
10451,2022-10,678,226,374,78,672,6
10451,2022-11,570,204,289,77,559,11
10451,2022-12,552,217,267,68,539,13
10451,2023-01,547,194,281,72,529,18
10451,2023-02,556,200,272,84,545,11
10451,2023-03,651,219,339,93,639,12
10451,2023-04,598,209,319,70,590,8
10451,2023-05,698,208,373,117,686,12
10451,2023-06,645,210,357,78,639,6
10451,2023-07,649,234,332,83,631,18
10451,2023-08,672,231,337,104,656,16
10451,2023-09,619,186,350,83,603,16
10451,2023-10,701,193,402,106,686,15
10451,2023-11,620,198,339,83,607,13
10451,2023-12,571,176,302,93,561,10
10451,2024-01,628,180,355,93,620,8
10451,2024-02,634,167,367,100,628,6
10451,2024-03,676,197,378,101,664,12
10451,2024-04,644,192,362,90,630,14
10451,2024-05,715,204,394,117,701,14
10451,2024-06,682,209,368,105,674,8
10451,2024-07,730,233,391,106,712,18
10451,2024-08,705,194,409,102,697,8
10451,2024-09,686,225,357,104,677,9
10451,2024-10,751,224,426,101,746,5
10451,2024-11,689,207,381,101,680,9
10451,2024-12,663,204,372,87,656,7
10452,2020-01,434,132,219,83,430,4
10452,2020-02,401,126,220,55,396,5
10452,2020-03,414,123,221,70,410,4
10452,2020-04,323,95,173,55,315,8
10452,2020-05,397,112,227,58,386,11
10452,2020-06,413,152,208,53,406,7
10452,2020-07,429,133,236,60,423,6
10452,2020-08,470,150,251,69,462,8
10452,2020-09,412,133,203,76,405,7
10452,2020-10,457,148,236,73,449,8
10452,2020-11,454,140,248,66,443,11
10452,2020-12,379,114,196,69,369,10
10452,2021-01,380,123,198,59,374,6
10452,2021-02,356,120,186,50,345,11
10452,2021-03,413,107,227,79,404,9
10452,2021-04,315,115,151,49,307,8
10452,2021-05,365,110,187,68,358,7
10452,2021-06,427,149,217,61,415,12
10452,2021-07,484,161,240,83,474,10
10452,2021-08,427,169,195,63,418,9
10452,2021-09,507,185,246,76,498,9
10452,2021-10,541,187,266,88,529,12
10452,2021-11,481,168,248,65,476,5
10452,2021-12,529,188,257,84,520,9
10452,2022-01,482,180,214,88,475,7
10452,2022-02,500,184,226,90,488,12
10452,2022-03,557,183,262,112,537,20
10452,2022-04,532,188,266,78,515,17
10452,2022-05,581,216,275,90,566,15
10452,2022-06,600,229,278,93,582,18
10452,2022-07,584,241,269,74,570,14
10452,2022-08,591,203,312,76,574,17
10452,2022-09,524,198,258,68,516,8
10452,2022-10,509,182,258,69,500,9
10452,2022-11,485,178,245,62,477,8
10452,2022-12,516,163,269,84,504,12
10452,2023-01,549,189,263,97,543,6
10452,2023-02,546,174,291,81,531,15
10452,2023-03,556,154,307,95,548,8
10452,2023-04,573,196,304,73,558,15
10452,2023-05,529,175,282,72,518,11
10452,2023-06,576,201,296,79,567,9
10452,2023-07,582,217,283,82,559,23
10452,2023-08,570,216,260,94,558,12
10452,2023-09,480,164,243,73,473,7
10452,2023-10,544,185,287,72,535,9
10452,2023-11,531,200,250,81,520,11
10452,2023-12,534,177,273,84,527,7
10452,2024-01,554,162,302,90,546,8
10452,2024-02,530,179,260,91,523,7
10452,2024-03,560,185,290,85,547,13
10452,2024-04,550,202,282,66,548,2
10452,2024-05,659,221,339,99,652,7
10452,2024-06,578,194,293,91,567,11
10452,2024-07,668,244,341,83,660,8
10452,2024-08,635,189,346,100,631,4
10452,2024-09,672,202,376,94,662,10
10452,2024-10,674,235,339,100,668,6
10452,2024-11,657,221,333,103,648,9
10452,2024-12,563,165,302,96,557,6
10453,2020-01,394,117,197,80,386,8
10453,2020-02,406,106,205,95,403,3
10453,2020-03,380,127,203,50,373,7
10453,2020-04,318,116,153,49,311,7
10453,2020-05,405,133,207,65,403,2
10453,2020-06,493,179,227,87,488,5
10453,2020-07,430,121,229,80,425,5
10453,2020-08,497,151,264,82,492,5
10453,2020-09,437,137,211,89,432,5
10453,2020-10,415,113,229,73,414,1
10453,2020-11,360,94,191,75,354,6
10453,2020-12,378,115,202,61,374,4
10453,2021-01,370,107,185,78,367,3
10453,2021-02,345,105,167,73,342,3
10453,2021-03,386,124,193,69,380,6
10453,2021-04,387,118,190,79,382,5
10453,2021-05,403,141,168,94,395,8
10453,2021-06,468,146,232,90,463,5
10453,2021-07,464,109,271,84,458,6
10453,2021-08,431,104,240,87,427,4
10453,2021-09,443,127,236,80,440,3
10453,2021-10,476,141,222,113,469,7
10453,2021-11,428,135,203,90,421,7
10453,2021-12,384,117,183,84,379,5
10453,2022-01,426,137,197,92,419,7
10453,2022-02,391,97,201,93,386,5
10453,2022-03,547,163,269,115,542,5
10453,2022-04,486,131,238,117,486,0
10453,2022-05,503,157,238,108,495,8
10453,2022-06,506,140,271,95,501,5
10453,2022-07,509,154,266,89,499,10
10453,2022-08,490,142,264,84,483,7
10453,2022-09,444,151,221,72,438,6
10453,2022-10,462,157,224,81,459,3
10453,2022-11,439,125,230,84,432,7
10453,2022-12,405,139,195,71,400,5
10453,2023-01,444,142,221,81,440,4
10453,2023-02,370,107,182,81,362,8
10453,2023-03,484,141,247,96,479,5
10453,2023-04,377,110,189,78,374,3
10453,2023-05,503,143,270,90,499,4
10453,2023-06,529,176,271,82,521,8
10453,2023-07,573,197,275,101,569,4
10453,2023-08,556,161,281,114,555,1
10453,2023-09,532,156,273,103,528,4
10453,2023-10,568,157,336,75,563,5
10453,2023-11,457,125,248,84,455,2
10453,2023-12,481,138,265,78,474,7
10453,2024-01,467,133,246,88,462,5
10453,2024-02,526,172,268,86,521,5
10453,2024-03,519,162,280,77,513,6
10453,2024-04,504,147,270,87,501,3
10453,2024-05,561,183,287,91,555,6
10453,2024-06,525,168,274,83,521,4
10453,2024-07,536,217,247,72,529,7
10453,2024-08,531,201,243,87,522,9
10453,2024-09,516,189,261,66,512,4
10453,2024-10,491,159,229,103,488,3
10453,2024-11,526,162,272,92,520,6
10453,2024-12,427,129,222,76,419,8
10454,2020-01,408,125,209,74,401,7
10454,2020-02,343,106,176,61,337,6
10454,2020-03,303,100,159,44,298,5
10454,2020-04,295,91,163,41,293,2
10454,2020-05,343,105,190,48,341,2
10454,2020-06,304,124,131,49,293,11
10454,2020-07,282,104,143,35,278,4
10454,2020-08,316,120,149,47,310,6
10454,2020-09,323,120,160,43,316,7
10454,2020-10,333,120,161,52,330,3
10454,2020-11,299,91,154,54,292,7
10454,2020-12,305,114,138,53,298,7
10454,2021-01,316,94,169,53,313,3
10454,2021-02,239,77,117,45,237,2
10454,2021-03,286,78,158,50,283,3
10454,2021-04,258,87,115,56,256,2
10454,2021-05,315,97,158,60,311,4
10454,2021-06,321,110,162,49,311,10
10454,2021-07,303,93,156,54,303,0
10454,2021-08,341,117,169,55,332,9
10454,2021-09,293,99,145,49,290,3
10454,2021-10,339,114,170,55,335,4
10454,2021-11,342,124,162,56,336,6
10454,2021-12,291,98,144,49,287,4
10454,2022-01,317,116,137,64,312,5
10454,2022-02,316,106,164,46,314,2
10454,2022-03,372,128,176,68,366,6
10454,2022-04,346,114,179,53,343,3
10454,2022-05,391,146,192,53,386,5
10454,2022-06,361,148,162,51,356,5
10454,2022-07,361,117,190,54,357,4
10454,2022-08,380,141,187,52,376,4
10454,2022-09,383,133,198,52,379,4
10454,2022-10,413,129,217,67,410,3
10454,2022-11,404,134,210,60,399,5
10454,2022-12,403,123,217,63,395,8
10454,2023-01,407,138,209,60,396,11
10454,2023-02,300,92,165,43,294,6
10454,2023-03,347,112,183,52,339,8
10454,2023-04,385,141,175,69,379,6
10454,2023-05,463,182,211,70,449,14
10454,2023-06,385,136,183,66,379,6
10454,2023-07,386,170,169,47,376,10
10454,2023-08,400,165,189,46,394,6
10454,2023-09,376,151,169,56,373,3
10454,2023-10,405,162,173,70,395,10
10454,2023-11,354,121,169,64,350,4
10454,2023-12,342,125,169,48,333,9
10454,2024-01,335,112,167,56,327,8
10454,2024-02,358,129,164,65,353,5
10454,2024-03,390,119,204,67,386,4
10454,2024-04,347,120,159,68,341,6
10454,2024-05,411,144,205,62,407,4
10454,2024-06,384,123,196,65,376,8
10454,2024-07,376,134,174,68,370,6
10454,2024-08,371,153,163,55,362,9
10454,2024-09,388,137,186,65,380,8
10454,2024-10,416,152,208,56,406,10
10454,2024-11,411,128,217,66,408,3
10454,2024-12,378,110,210,58,371,7
10455,2020-01,456,124,256,76,450,6
10455,2020-02,431,142,217,72,425,6
10455,2020-03,383,115,208,60,375,8
10455,2020-04,293,87,167,39,288,5
10455,2020-05,384,132,189,63,377,7
10455,2020-06,351,109,184,58,345,6
10455,2020-07,339,96,185,58,336,3
10455,2020-08,395,133,170,92,388,7
10455,2020-09,377,152,151,74,368,9
10455,2020-10,426,151,208,67,421,5
10455,2020-11,360,133,172,55,353,7
10455,2020-12,337,108,177,52,332,5
10455,2021-01,360,111,203,46,355,5
10455,2021-02,315,93,167,55,314,1
10455,2021-03,376,123,190,63,368,8
10455,2021-04,306,105,142,59,299,7
10455,2021-05,365,117,176,72,359,6
10455,2021-06,361,131,170,60,358,3
10455,2021-07,402,139,196,67,396,6
10455,2021-08,364,142,163,59,354,10
10455,2021-09,380,130,178,72,374,6
10455,2021-10,424,163,184,77,416,8
10455,2021-11,400,144,186,70,391,9
10455,2021-12,391,160,180,51,387,4
10455,2022-01,332,119,158,55,324,8
10455,2022-02,372,139,165,68,371,1
10455,2022-03,482,166,245,71,475,7
10455,2022-04,401,143,188,70,396,5
10455,2022-05,518,178,267,73,511,7
10455,2022-06,536,156,311,69,532,4
10455,2022-07,532,185,289,58,525,7
10455,2022-08,484,162,253,69,483,1
10455,2022-09,472,172,248,52,465,7
10455,2022-10,539,177,299,63,535,4
10455,2022-11,480,162,258,60,472,8
10455,2022-12,457,147,226,84,449,8
10455,2023-01,491,141,266,84,487,4
10455,2023-02,458,148,239,71,454,4
10455,2023-03,537,198,264,75,526,11
10455,2023-04,479,169,227,83,467,12
10455,2023-05,532,185,243,104,522,10
10455,2023-06,556,199,283,74,540,16
10455,2023-07,540,214,241,85,525,15
10455,2023-08,578,200,287,91,572,6
10455,2023-09,551,220,252,79,542,9
10455,2023-10,600,207,296,97,593,7
10455,2023-11,530,167,284,79,522,8
10455,2023-12,570,206,296,68,557,13
10455,2024-01,537,174,300,63,528,9
10455,2024-02,550,166,290,94,536,14
10455,2024-03,590,198,306,86,582,8
10455,2024-04,601,184,311,106,595,6
10455,2024-05,594,201,307,86,580,14
10455,2024-06,586,181,325,80,584,2
10455,2024-07,590,177,322,91,578,12
10455,2024-08,697,221,379,97,688,9
10455,2024-09,563,171,306,86,558,5
10455,2024-10,604,191,327,86,593,11
10455,2024-11,686,202,412,72,681,5
10455,2024-12,620,168,397,55,617,3
10456,2020-01,575,151,296,128,569,6
10456,2020-02,451,118,235,98,444,7
10456,2020-03,487,137,252,98,478,9
10456,2020-04,339,94,193,52,337,2
10456,2020-05,493,147,257,89,489,4
10456,2020-06,526,172,253,101,516,10
10456,2020-07,514,159,246,109,504,10
10456,2020-08,546,166,270,110,540,6
10456,2020-09,513,158,247,108,507,6
10456,2020-10,574,177,276,121,568,6
10456,2020-11,544,188,246,110,531,13
10456,2020-12,530,156,264,110,524,6
10456,2021-01,469,135,231,103,463,6
10456,2021-02,432,142,203,87,425,7
10456,2021-03,537,162,272,103,526,10
10456,2021-04,475,138,233,104,467,7
10456,2021-05,553,183,271,99,539,14
10456,2021-06,527,178,240,109,516,11
10456,2021-07,493,166,227,100,483,10
10456,2021-08,545,210,231,104,532,13
10456,2021-09,552,199,249,104,545,7
10456,2021-10,568,220,249,99,555,13
10456,2021-11,503,191,213,99,496,7
10456,2021-12,551,196,251,104,546,5
10456,2022-01,541,192,242,107,524,17
10456,2022-02,515,180,215,120,506,9
10456,2022-03,628,211,288,129,617,11
10456,2022-04,625,228,266,131,607,18
10456,2022-05,595,219,255,121,582,13
10456,2022-06,662,262,268,132,651,11
10456,2022-07,620,236,274,110,613,7
10456,2022-08,622,241,274,107,613,9
10456,2022-09,606,226,266,114,594,12
10456,2022-10,570,226,240,104,561,9
10456,2022-11,554,191,269,94,541,13
10456,2022-12,511,181,232,98,504,7
10456,2023-01,639,228,293,118,619,20
10456,2023-02,579,196,282,101,570,9
10456,2023-03,682,252,307,123,668,14
10456,2023-04,607,225,270,112,592,15
10456,2023-05,677,219,324,134,669,8
10456,2023-06,666,236,326,104,655,11
10456,2023-07,660,220,306,134,646,14
10456,2023-08,628,259,231,138,617,11
10456,2023-09,648,214,288,146,632,16
10456,2023-10,623,221,279,123,616,7
10456,2023-11,584,189,274,121,574,10
10456,2023-12,629,194,302,133,624,5
10456,2024-01,667,219,304,144,657,10
10456,2024-02,672,206,347,119,663,9
10456,2024-03,669,228,313,128,655,14
10456,2024-04,623,212,301,110,616,7
10456,2024-05,734,272,328,134,716,18
10456,2024-06,631,231,296,104,620,11
10456,2024-07,662,222,323,117,654,8
10456,2024-08,666,234,315,117,651,15
10456,2024-09,656,246,293,117,644,12
10456,2024-10,563,164,278,121,555,8
10456,2024-11,656,225,322,109,647,9
10456,2024-12,565,185,281,99,558,7
10457,2020-01,526,148,280,98,517,9
10457,2020-02,497,148,263,86,489,8
10457,2020-03,467,146,252,69,461,6
10457,2020-04,395,115,205,75,384,11
10457,2020-05,502,133,277,92,494,8
10457,2020-06,498,175,245,78,493,5
10457,2020-07,528,173,259,96,523,5
10457,2020-08,600,187,309,104,591,9
10457,2020-09,534,171,267,96,525,9
10457,2020-10,544,193,261,90,531,13
10457,2020-11,523,183,265,75,516,7
10457,2020-12,458,132,255,71,455,3
10457,2021-01,467,132,242,93,461,6
10457,2021-02,409,134,209,66,405,4
10457,2021-03,476,157,231,88,467,9
10457,2021-04,419,147,207,65,407,12
10457,2021-05,478,151,236,91,473,5
10457,2021-06,536,182,282,72,525,11
10457,2021-07,536,193,238,105,527,9
10457,2021-08,521,178,262,81,518,3
10457,2021-09,486,163,245,78,474,12
10457,2021-10,566,208,266,92,558,8
10457,2021-11,547,193,257,97,539,8
10457,2021-12,535,178,261,96,531,4
10457,2022-01,472,169,218,85,467,5
10457,2022-02,457,163,217,77,447,10
10457,2022-03,539,192,237,110,532,7
10457,2022-04,549,164,287,98,545,4
10457,2022-05,582,194,284,104,577,5
10457,2022-06,557,197,274,86,550,7
10457,2022-07,656,223,343,90,644,12
10457,2022-08,606,177,318,111,597,9
10457,2022-09,652,224,327,101,637,15
10457,2022-10,629,178,352,99,623,6
10457,2022-11,644,174,364,106,634,10
10457,2022-12,621,195,334,92,615,6
10457,2023-01,696,220,380,96,683,13
10457,2023-02,560,189,291,80,551,9
10457,2023-03,603,188,316,99,588,15
10457,2023-04,676,229,348,99,663,13
10457,2023-05,736,207,403,126,729,7
10457,2023-06,618,210,318,90,609,9
10457,2023-07,701,250,342,109,683,18
10457,2023-08,620,208,337,75,607,13
10457,2023-09,674,215,370,89,667,7
10457,2023-10,755,226,403,126,745,10
10457,2023-11,582,180,305,97,577,5
10457,2023-12,676,237,328,111,664,12
10457,2024-01,620,201,311,108,613,7
10457,2024-02,567,175,302,90,562,5
10457,2024-03,661,188,366,107,653,8
10457,2024-04,640,218,332,90,634,6
10457,2024-05,711,269,334,108,701,10
10457,2024-06,715,275,328,112,703,12
10457,2024-07,726,255,364,107,721,5
10457,2024-08,678,240,333,105,669,9
10457,2024-09,680,247,307,126,675,5
10457,2024-10,662,242,307,113,656,6
10457,2024-11,660,200,341,119,653,7
10457,2024-12,590,195,284,111,584,6
10458,2020-01,509,154,280,75,504,5
10458,2020-02,409,121,226,62,394,15
10458,2020-03,372,122,182,68,366,6
10458,2020-04,332,109,164,59,327,5
10458,2020-05,390,123,196,71,386,4
10458,2020-06,410,149,199,62,402,8
10458,2020-07,414,149,198,67,406,8
10458,2020-08,474,189,206,79,468,6
10458,2020-09,414,157,192,65,412,2
10458,2020-10,445,143,234,68,440,5
10458,2020-11,440,161,206,73,432,8
10458,2020-12,413,121,221,71,406,7
10458,2021-01,378,133,172,73,375,3
10458,2021-02,291,95,149,47,288,3
10458,2021-03,409,151,186,72,402,7
10458,2021-04,399,146,194,59,399,0
10458,2021-05,436,166,195,75,431,5
10458,2021-06,462,178,213,71,454,8
10458,2021-07,509,198,236,75,500,9
10458,2021-08,446,176,186,84,443,3
10458,2021-09,511,183,246,82,499,12
10458,2021-10,552,189,281,82,548,4
10458,2021-11,558,207,283,68,550,8
10458,2021-12,549,194,279,76,542,7
10458,2022-01,593,140,373,80,585,8
10458,2022-02,613,199,339,75,604,9
10458,2022-03,614,163,375,76,608,6
10458,2022-04,582,173,333,76,578,4
10458,2022-05,638,193,354,91,628,10
10458,2022-06,650,199,368,83,646,4
10458,2022-07,663,201,371,91,654,9
10458,2022-08,573,192,318,63,566,7
10458,2022-09,521,147,299,75,518,3
10458,2022-10,557,174,304,79,556,1
10458,2022-11,603,194,333,76,598,5
10458,2022-12,502,160,275,67,493,9
10458,2023-01,562,173,311,78,553,9
10458,2023-02,531,166,296,69,527,4
10458,2023-03,553,149,321,83,545,8
10458,2023-04,598,182,355,61,588,10
10458,2023-05,694,193,404,97,684,10
10458,2023-06,624,198,358,68,612,12
10458,2023-07,634,208,355,71,628,6
10458,2023-08,572,194,304,74,565,7
10458,2023-09,578,204,321,53,574,4
10458,2023-10,596,197,325,74,582,14
10458,2023-11,538,170,290,78,529,9
10458,2023-12,563,181,299,83,556,7
10458,2024-01,601,198,320,83,592,9
10458,2024-02,507,185,252,70,497,10
10458,2024-03,508,157,270,81,497,11
10458,2024-04,564,223,278,63,555,9
10458,2024-05,598,222,276,100,587,11
10458,2024-06,595,224,302,69,588,7
10458,2024-07,642,247,307,88,628,14
10458,2024-08,639,241,320,78,629,10
10458,2024-09,632,231,303,98,625,7
10458,2024-10,692,253,351,88,679,13
10458,2024-11,555,185,290,80,549,6
10458,2024-12,534,193,284,57,523,11
10459,2020-01,402,127,196,79,396,6
10459,2020-02,328,97,177,54,324,4
10459,2020-03,327,94,176,57,326,1
10459,2020-04,270,75,156,39,267,3
10459,2020-05,339,90,190,59,335,4
10459,2020-06,342,100,183,59,338,4
10459,2020-07,295,66,148,81,291,4
10459,2020-08,345,107,174,64,342,3
10459,2020-09,307,106,143,58,303,4
10459,2020-10,351,90,190,71,343,8
10459,2020-11,337,115,165,57,334,3
10459,2020-12,346,112,192,42,336,10
10459,2021-01,344,110,185,49,342,2
10459,2021-02,282,74,162,46,279,3
10459,2021-03,341,111,177,53,339,2
10459,2021-04,337,113,178,46,331,6
10459,2021-05,369,138,166,65,364,5
10459,2021-06,337,116,147,74,331,6
10459,2021-07,373,138,175,60,364,9
10459,2021-08,335,121,158,56,330,5
10459,2021-09,340,118,150,72,337,3
10459,2021-10,379,137,174,68,372,7
10459,2021-11,399,148,181,70,386,13
10459,2021-12,419,154,183,82,405,14
10459,2022-01,433,129,214,90,428,5
10459,2022-02,362,129,175,58,361,1
10459,2022-03,460,151,214,95,457,3
10459,2022-04,385,111,191,83,379,6
10459,2022-05,472,146,236,90,463,9
10459,2022-06,464,141,227,96,457,7
10459,2022-07,445,167,208,70,431,14
10459,2022-08,399,137,185,77,395,4
10459,2022-09,426,124,194,108,420,6
10459,2022-10,443,156,205,82,433,10
10459,2022-11,439,162,191,86,435,4
10459,2022-12,380,138,173,69,379,1
10459,2023-01,469,178,195,96,454,15
10459,2023-02,416,132,204,80,409,7
10459,2023-03,491,171,242,78,482,9
10459,2023-04,468,166,213,89,464,4
10459,2023-05,510,179,232,99,506,4
10459,2023-06,513,200,208,105,505,8
10459,2023-07,487,194,209,84,473,14
10459,2023-08,468,171,221,76,460,8
10459,2023-09,494,184,229,81,485,9
10459,2023-10,523,162,266,95,517,6
10459,2023-11,466,157,224,85,456,10
10459,2023-12,471,162,237,72,463,8
10459,2024-01,497,160,246,91,487,10
10459,2024-02,436,146,213,77,426,10
10459,2024-03,444,142,218,84,439,5
10459,2024-04,465,159,223,83,460,5
10459,2024-05,508,150,266,92,501,7
10459,2024-06,502,162,252,88,494,8
10459,2024-07,554,183,287,84,543,11
10459,2024-08,525,183,247,95,519,6
10459,2024-09,545,158,280,107,534,11
10459,2024-10,512,151,271,90,506,6
10459,2024-11,445,148,224,73,444,1
10459,2024-12,411,130,219,62,403,8
10460,2020-01,446,104,260,82,439,7
10460,2020-02,426,119,221,86,420,6
10460,2020-03,441,125,232,84,438,3
10460,2020-04,310,93,160,57,304,6
10460,2020-05,434,108,246,80,427,7
10460,2020-06,443,119,238,86,435,8
10460,2020-07,411,128,179,104,406,5
10460,2020-08,407,123,202,82,401,6
10460,2020-09,396,135,185,76,388,8
10460,2020-10,374,110,199,65,367,7
10460,2020-11,373,127,176,70,367,6
10460,2020-12,403,132,204,67,391,12
10460,2021-01,373,120,197,56,366,7
10460,2021-02,337,115,160,62,334,3
10460,2021-03,396,121,193,82,390,5
10460,2021-04,388,115,195,78,383,5
10460,2021-05,417,154,187,76,412,5
10460,2021-06,404,132,197,75,397,7
10460,2021-07,447,161,211,75,443,4
10460,2021-08,453,161,217,75,437,16
10460,2021-09,452,146,227,79,449,3
10460,2021-10,473,179,214,80,466,7
10460,2021-11,409,129,202,78,400,9
10460,2021-12,449,151,218,80,443,6
10460,2022-01,427,138,208,81,418,9
10460,2022-02,425,149,201,75,414,11
10460,2022-03,505,159,247,99,500,5
10460,2022-04,461,163,200,98,451,10
10460,2022-05,482,174,208,100,478,4
10460,2022-06,524,179,234,111,513,11
10460,2022-07,562,196,273,93,549,13
10460,2022-08,512,179,229,104,499,13
10460,2022-09,487,195,228,64,485,2
10460,2022-10,507,190,230,87,492,15
10460,2022-11,483,153,220,110,472,11
10460,2022-12,496,173,234,89,489,7
10460,2023-01,520,154,274,92,514,6
10460,2023-02,393,122,212,59,386,7
10460,2023-03,541,193,247,101,532,9
10460,2023-04,478,165,216,97,472,6
10460,2023-05,533,176,261,96,523,10
10460,2023-06,475,138,243,94,463,12
10460,2023-07,498,165,253,80,483,15
10460,2023-08,558,198,258,102,545,13
10460,2023-09,476,176,233,67,464,12
10460,2023-10,553,169,276,108,549,4
10460,2023-11,482,146,249,87,474,8
10460,2023-12,487,161,227,99,476,11
10460,2024-01,516,168,239,109,506,10
10460,2024-02,446,144,222,80,442,4
10460,2024-03,535,198,248,89,527,8
10460,2024-04,453,162,197,94,446,7
10460,2024-05,486,175,228,83,478,8
10460,2024-06,509,164,245,100,499,10
10460,2024-07,618,224,296,98,606,12
10460,2024-08,547,184,247,116,539,8
10460,2024-09,554,175,273,106,549,5
10460,2024-10,513,160,264,89,506,7
10460,2024-11,537,170,270,97,530,7
10460,2024-12,468,114,272,82,465,3
10461,2020-01,262,70,143,49,257,5
10461,2020-02,234,68,117,49,229,5
10461,2020-03,197,66,90,41,190,7
10461,2020-04,166,58,82,26,163,3
10461,2020-05,213,55,116,42,210,3
10461,2020-06,215,55,127,33,212,3
10461,2020-07,237,64,123,50,235,2
10461,2020-08,234,75,114,45,230,4
10461,2020-09,222,68,114,40,219,3
10461,2020-10,217,72,104,41,214,3
10461,2020-11,220,76,107,37,219,1
10461,2020-12,222,60,128,34,217,5
10461,2021-01,202,65,106,31,201,1
10461,2021-02,147,50,66,31,144,3
10461,2021-03,218,64,115,39,213,5
10461,2021-04,185,57,89,39,183,2
10461,2021-05,212,63,99,50,206,6
10461,2021-06,227,77,108,42,222,5
10461,2021-07,242,88,107,47,238,4
10461,2021-08,278,89,132,57,277,1
10461,2021-09,229,83,105,41,223,6
10461,2021-10,284,85,143,56,277,7
10461,2021-11,268,103,120,45,257,11
10461,2021-12,254,92,122,40,250,4
10461,2022-01,224,76,111,37,221,3
10461,2022-02,230,79,115,36,227,3
10461,2022-03,257,99,117,41,252,5
10461,2022-04,265,90,128,47,259,6
10461,2022-05,301,96,150,55,297,4
10461,2022-06,289,87,146,56,283,6
10461,2022-07,270,95,133,42,267,3
10461,2022-08,325,97,180,48,321,4
10461,2022-09,250,69,132,49,250,0
10461,2022-10,330,112,149,69,323,7
10461,2022-11,279,106,123,50,274,5
10461,2022-12,307,110,162,35,300,7
10461,2023-01,354,115,191,48,346,8
10461,2023-02,249,84,137,28,241,8
10461,2023-03,307,112,143,52,301,6
10461,2023-04,294,121,127,46,285,9
10461,2023-05,315,102,177,36,308,7
10461,2023-06,347,128,174,45,337,10
10461,2023-07,302,101,147,54,301,1
10461,2023-08,350,123,173,54,341,9
10461,2023-09,306,111,154,41,302,4
10461,2023-10,315,116,159,40,313,2
10461,2023-11,298,110,141,47,294,4
10461,2023-12,308,121,144,43,306,2
10461,2024-01,305,114,140,51,301,4
10461,2024-02,299,107,154,38,298,1
10461,2024-03,324,120,156,48,323,1
10461,2024-04,291,90,157,44,286,5
10461,2024-05,280,109,115,56,277,3
10461,2024-06,347,137,154,56,341,6
10461,2024-07,346,126,175,45,339,7
10461,2024-08,313,126,138,49,305,8
10461,2024-09,327,124,160,43,323,4
10461,2024-10,325,122,150,53,317,8
10461,2024-11,297,105,157,35,292,5
10461,2024-12,233,82,110,41,231,2
10462,2020-01,310,80,174,56,307,3
10462,2020-02,271,70,149,52,265,6
10462,2020-03,227,60,116,51,222,5
10462,2020-04,193,50,116,27,190,3
10462,2020-05,235,66,132,37,234,1
10462,2020-06,228,74,123,31,225,3
10462,2020-07,266,78,136,52,263,3
10462,2020-08,252,77,130,45,251,1
10462,2020-09,220,87,95,38,218,2
10462,2020-10,261,89,132,40,259,2
10462,2020-11,260,94,116,50,256,4
10462,2020-12,253,87,124,42,250,3
10462,2021-01,287,82,153,52,284,3
10462,2021-02,227,77,110,40,222,5
10462,2021-03,251,88,115,48,250,1
10462,2021-04,215,88,95,32,208,7
10462,2021-05,271,101,101,69,267,4
10462,2021-06,254,99,104,51,249,5
10462,2021-07,311,112,147,52,306,5
10462,2021-08,287,115,123,49,275,12
10462,2021-09,276,111,111,54,271,5
10462,2021-10,306,117,126,63,296,10
10462,2021-11,288,120,118,50,283,5
10462,2021-12,340,129,149,62,337,3
10462,2022-01,280,125,94,61,271,9
10462,2022-02,277,115,120,42,269,8
10462,2022-03,355,119,176,60,351,4
10462,2022-04,304,103,141,60,298,6
10462,2022-05,354,122,175,57,344,10
10462,2022-06,334,110,160,64,327,7
10462,2022-07,335,136,160,39,332,3
10462,2022-08,348,110,169,69,345,3
10462,2022-09,399,176,155,68,389,10
10462,2022-10,420,161,189,70,415,5
10462,2022-11,367,136,176,55,362,5
10462,2022-12,403,165,187,51,398,5
10462,2023-01,397,151,192,54,388,9
10462,2023-02,336,112,164,60,324,12
10462,2023-03,339,121,174,44,334,5
10462,2023-04,378,131,194,53,373,5
10462,2023-05,343,136,162,45,336,7
10462,2023-06,349,130,151,68,342,7
10462,2023-07,386,125,215,46,384,2
10462,2023-08,358,158,143,57,352,6
10462,2023-09,381,139,187,55,377,4
10462,2023-10,354,123,177,54,349,5
10462,2023-11,363,132,172,59,359,4
10462,2023-12,357,128,174,55,349,8
10462,2024-01,372,155,166,51,365,7
10462,2024-02,364,128,175,61,357,7
10462,2024-03,408,176,184,48,402,6
10462,2024-04,347,119,167,61,340,7
10462,2024-05,377,135,188,54,369,8
10462,2024-06,357,141,161,55,352,5
10462,2024-07,428,146,226,56,424,4
10462,2024-08,398,175,166,57,389,9
10462,2024-09,329,129,145,55,325,4
10462,2024-10,402,155,180,67,393,9
10462,2024-11,347,124,179,44,337,10
10462,2024-12,330,124,156,50,321,9
10463,2020-01,378,95,225,58,372,6
10463,2020-02,302,79,165,58,298,4
10463,2020-03,276,52,190,34,276,0
10463,2020-04,222,55,136,31,217,5
10463,2020-05,286,63,174,49,285,1
10463,2020-06,246,58,144,44,243,3
10463,2020-07,268,63,160,45,264,4
10463,2020-08,253,93,123,37,250,3
10463,2020-09,290,90,155,45,285,5
10463,2020-10,302,92,165,45,296,6
10463,2020-11,325,93,194,38,317,8
10463,2020-12,316,102,169,45,310,6
10463,2021-01,257,60,151,46,252,5
10463,2021-02,231,52,150,29,227,4
10463,2021-03,292,77,168,47,290,2
10463,2021-04,257,61,151,45,254,3
10463,2021-05,315,77,203,35,312,3
10463,2021-06,319,97,158,64,316,3
10463,2021-07,322,80,199,43,320,2
10463,2021-08,373,91,229,53,366,7
10463,2021-09,351,96,198,57,348,3
10463,2021-10,385,113,197,75,379,6
10463,2021-11,324,102,187,35,320,4
10463,2021-12,351,107,191,53,346,5
10463,2022-01,369,130,186,53,363,6
10463,2022-02,336,105,180,51,333,3
10463,2022-03,462,138,260,64,455,7
10463,2022-04,374,116,212,46,367,7
10463,2022-05,442,116,243,83,440,2
10463,2022-06,480,139,272,69,477,3
10463,2022-07,473,135,266,72,468,5
10463,2022-08,395,124,222,49,386,9
10463,2022-09,391,104,207,80,387,4
10463,2022-10,437,143,237,57,430,7
10463,2022-11,357,113,192,52,354,3
10463,2022-12,366,117,193,56,363,3
10463,2023-01,373,115,219,39,367,6
10463,2023-02,320,128,152,40,314,6
10463,2023-03,405,116,228,61,398,7
10463,2023-04,417,140,231,46,406,11
10463,2023-05,439,141,228,70,432,7
10463,2023-06,387,124,203,60,376,11
10463,2023-07,390,108,214,68,386,4
10463,2023-08,407,123,225,59,401,6
10463,2023-09,404,140,229,35,399,5
10463,2023-10,444,130,257,57,430,14
10463,2023-11,447,123,257,67,441,6
10463,2023-12,386,131,207,48,377,9
10463,2024-01,391,138,189,64,383,8
10463,2024-02,362,138,173,51,352,10
10463,2024-03,402,122,217,63,396,6
10463,2024-04,380,118,209,53,375,5
10463,2024-05,397,139,191,67,393,4
10463,2024-06,411,129,216,66,406,5
10463,2024-07,467,189,219,59,462,5
10463,2024-08,401,140,205,56,394,7
10463,2024-09,371,112,199,60,368,3
10463,2024-10,457,151,223,83,443,14
10463,2024-11,344,125,162,57,342,2
10463,2024-12,283,93,142,48,274,9
10464,2020-01,12,3,8,1,12,0
10464,2020-02,8,2,4,2,8,0
10464,2020-03,12,2,4,6,12,0
10464,2020-04,6,2,1,3,6,0
10464,2020-05,17,5,8,4,17,0
10464,2020-06,32,4,16,12,32,0
10464,2020-07,26,4,15,7,26,0
10464,2020-08,24,7,10,7,24,0
10464,2020-09,21,8,11,2,21,0
10464,2020-10,15,2,9,4,15,0
10464,2020-11,17,3,11,3,17,0
10464,2020-12,14,6,5,3,12,2
10464,2021-01,11,2,7,2,11,0
10464,2021-02,15,5,8,2,15,0
10464,2021-03,20,5,10,5,20,0
10464,2021-04,15,3,9,3,15,0
10464,2021-05,19,7,6,6,19,0
10464,2021-06,21,5,13,3,21,0
10464,2021-07,20,5,13,2,19,1
10464,2021-08,26,5,14,7,26,0
10464,2021-09,16,5,5,6,16,0
10464,2021-10,12,4,5,3,12,0
10464,2021-11,10,4,1,5,10,0
10464,2021-12,6,3,2,1,6,0
10464,2022-01,11,5,3,3,11,0
10464,2022-02,6,3,3,0,6,0
10464,2022-03,19,13,5,1,19,0
10464,2022-04,17,4,8,5,17,0
10464,2022-05,17,8,6,3,17,0
10464,2022-06,13,6,6,1,13,0
10464,2022-07,33,15,11,7,32,1
10464,2022-08,17,6,7,4,17,0
10464,2022-09,21,5,10,6,21,0
10464,2022-10,28,12,12,4,27,1
10464,2022-11,13,5,6,2,13,0
10464,2022-12,6,1,5,0,6,0
10464,2023-01,13,3,8,2,13,0
10464,2023-02,11,3,6,2,11,0
10464,2023-03,14,2,11,1,14,0
10464,2023-04,14,7,5,2,13,1
10464,2023-05,17,5,7,5,17,0
10464,2023-06,13,5,8,0,12,1
10464,2023-07,26,9,13,4,26,0
10464,2023-08,18,5,10,3,18,0
10464,2023-09,17,4,10,3,17,0
10464,2023-10,14,5,5,4,14,0
10464,2023-11,13,5,6,2,13,0
10464,2023-12,14,4,8,2,13,1
10464,2024-01,10,4,4,2,10,0
10464,2024-02,20,4,14,2,20,0
10464,2024-03,14,3,10,1,14,0
10464,2024-04,13,4,8,1,13,0
10464,2024-05,6,1,2,3,6,0
10464,2024-06,37,11,19,7,37,0
10464,2024-07,34,12,17,5,34,0
10464,2024-08,26,3,14,9,26,0
10464,2024-09,12,6,4,2,11,1
10464,2024-10,17,6,9,2,17,0
10464,2024-11,10,1,6,3,9,1
10464,2024-12,16,9,4,3,16,0
10465,2020-01,190,49,106,35,188,2
10465,2020-02,170,40,104,26,168,2
10465,2020-03,155,36,74,45,153,2
10465,2020-04,131,33,67,31,130,1
10465,2020-05,141,34,75,32,139,2
10465,2020-06,179,49,85,45,174,5
10465,2020-07,154,41,77,36,151,3
10465,2020-08,144,32,76,36,143,1
10465,2020-09,150,40,69,41,147,3
10465,2020-10,153,45,71,37,152,1
10465,2020-11,163,37,89,37,158,5
10465,2020-12,150,42,65,43,146,4
10465,2021-01,126,37,70,19,125,1
10465,2021-02,123,40,60,23,119,4
10465,2021-03,167,41,94,32,166,1
10465,2021-04,166,47,82,37,164,1
10465,2021-05,156,44,85,27,155,1
10465,2021-06,164,52,74,38,160,4
10465,2021-07,198,54,113,31,194,4
10465,2021-08,180,45,92,43,178,2
10465,2021-09,230,69,124,37,226,4
10465,2021-10,193,48,89,56,190,3
10465,2021-11,209,66,99,44,204,5
10465,2021-12,162,45,87,30,161,1
10465,2022-01,162,57,76,29,161,1
10465,2022-02,163,58,80,25,161,2
10465,2022-03,182,38,117,27,180,2
10465,2022-04,204,45,116,43,201,3
10465,2022-05,200,55,106,39,197,3
10465,2022-06,200,56,106,38,196,4
10465,2022-07,214,63,101,50,211,3
10465,2022-08,213,58,118,37,212,1
10465,2022-09,200,60,97,43,197,3
10465,2022-10,180,52,101,27,180,0
10465,2022-11,194,56,111,27,191,3
10465,2022-12,200,73,100,27,199,1
10465,2023-01,175,55,98,22,169,6
10465,2023-02,208,84,85,39,199,9
10465,2023-03,227,69,115,43,222,5
10465,2023-04,245,74,137,34,238,7
10465,2023-05,238,82,119,37,232,6
10465,2023-06,245,80,135,30,240,5
10465,2023-07,213,54,122,37,212,1
10465,2023-08,232,65,134,33,227,5
10465,2023-09,249,81,126,42,243,6
10465,2023-10,247,96,116,35,244,3
10465,2023-11,221,59,128,34,216,5
10465,2023-12,211,66,108,37,207,4
10465,2024-01,236,84,117,35,232,4
10465,2024-02,220,70,118,32,220,0
10465,2024-03,261,85,139,37,257,4
10465,2024-04,260,76,136,48,258,2
10465,2024-05,242,81,117,44,239,3
10465,2024-06,213,57,119,37,208,5
10465,2024-07,263,93,130,40,263,0
10465,2024-08,253,77,141,35,251,2
10465,2024-09,267,77,143,47,265,2
10465,2024-10,238,66,138,34,236,2
10465,2024-11,250,71,140,39,247,3
10465,2024-12,160,46,83,31,158,2
10466,2020-01,299,80,176,43,293,6
10466,2020-02,276,78,151,47,270,6
10466,2020-03,317,94,150,73,308,9
10466,2020-04,220,64,118,38,217,3
10466,2020-05,324,89,170,65,322,2
10466,2020-06,284,78,147,59,279,5
10466,2020-07,339,73,191,75,333,6
10466,2020-08,305,92,145,68,299,6
10466,2020-09,370,100,204,66,368,2
10466,2020-10,378,95,207,76,371,7
10466,2020-11,353,88,187,78,348,5
10466,2020-12,331,123,153,55,321,10
10466,2021-01,363,121,187,55,358,5
10466,2021-02,276,91,129,56,270,6
10466,2021-03,339,100,186,53,333,6
10466,2021-04,340,107,165,68,336,4
10466,2021-05,364,116,172,76,355,9
10466,2021-06,411,131,186,94,403,8
10466,2021-07,399,131,187,81,395,4
10466,2021-08,426,105,217,104,425,1
10466,2021-09,380,113,191,76,370,10
10466,2021-10,425,146,192,87,421,4
10466,2021-11,417,141,201,75,410,7
10466,2021-12,364,137,159,68,357,7
10466,2022-01,394,156,169,69,390,4
10466,2022-02,360,98,195,67,356,4
10466,2022-03,447,124,241,82,439,8
10466,2022-04,418,121,217,80,415,3
10466,2022-05,432,146,185,101,424,8
10466,2022-06,377,135,177,65,372,5
10466,2022-07,430,137,199,94,425,5
10466,2022-08,436,127,203,106,432,4
10466,2022-09,395,125,189,81,394,1
10466,2022-10,368,121,163,84,365,3
10466,2022-11,359,116,154,89,353,6
10466,2022-12,368,124,162,82,366,2
10466,2023-01,354,120,163,71,347,7
10466,2023-02,336,117,153,66,332,4
10466,2023-03,393,156,173,64,379,14
10466,2023-04,374,128,163,83,366,8
10466,2023-05,385,139,178,68,381,4
10466,2023-06,440,168,198,74,434,6
10466,2023-07,521,224,220,77,513,8
10466,2023-08,416,159,189,68,406,10
10466,2023-09,393,144,168,81,388,5
10466,2023-10,450,154,219,77,443,7
10466,2023-11,440,153,194,93,433,7
10466,2023-12,422,153,200,69,416,6
10466,2024-01,437,175,185,77,426,11
10466,2024-02,367,127,179,61,364,3
10466,2024-03,371,155,150,66,362,9
10466,2024-04,364,125,177,62,358,6
10466,2024-05,475,148,244,83,472,3
10466,2024-06,446,140,225,81,442,4
10466,2024-07,462,148,231,83,458,4
10466,2024-08,441,161,213,67,434,7
10466,2024-09,411,141,195,75,410,1
10466,2024-10,433,169,195,69,427,6
10466,2024-11,408,158,176,74,403,5
10466,2024-12,387,142,170,75,382,5
10467,2020-01,539,163,293,83,529,10
10467,2020-02,475,138,261,76,468,7
10467,2020-03,527,138,299,90,524,3
10467,2020-04,395,113,225,57,392,3
10467,2020-05,530,157,289,84,523,7
10467,2020-06,472,136,247,89,466,6
10467,2020-07,541,150,289,102,537,4
10467,2020-08,543,194,258,91,537,6
10467,2020-09,512,172,259,81,504,8
10467,2020-10,549,185,273,91,547,2
10467,2020-11,561,176,298,87,557,4
10467,2020-12,488,149,263,76,481,7
10467,2021-01,487,157,242,88,481,6
10467,2021-02,412,121,219,72,411,1
10467,2021-03,486,160,244,82,478,8
10467,2021-04,453,142,230,81,445,8
10467,2021-05,528,162,255,111,523,5
10467,2021-06,521,173,249,99,513,8
10467,2021-07,560,201,263,96,552,8
10467,2021-08,483,156,242,85,479,4
10467,2021-09,574,182,297,95,557,17
10467,2021-10,551,179,267,105,540,11
10467,2021-11,574,184,284,106,565,9
10467,2021-12,609,247,267,95,601,8
10467,2022-01,514,162,248,104,508,6
10467,2022-02,452,156,193,103,443,9
10467,2022-03,545,183,255,107,541,4
10467,2022-04,537,177,258,102,524,13
10467,2022-05,575,179,268,128,567,8
10467,2022-06,622,211,283,128,608,14
10467,2022-07,551,210,246,95,536,15
10467,2022-08,585,209,248,128,573,12
10467,2022-09,615,224,269,122,605,10
10467,2022-10,669,243,307,119,658,11
10467,2022-11,572,210,264,98,560,12
10467,2022-12,594,216,267,111,587,7
10467,2023-01,565,190,266,109,554,11
10467,2023-02,503,168,233,102,499,4
10467,2023-03,583,202,274,107,573,10
10467,2023-04,582,221,275,86,570,12
10467,2023-05,686,231,316,139,675,11
10467,2023-06,635,251,278,106,618,17
10467,2023-07,626,227,290,109,609,17
10467,2023-08,640,236,283,121,628,12
10467,2023-09,637,241,299,97,621,16
10467,2023-10,667,224,326,117,657,10
10467,2023-11,623,230,288,105,614,9
10467,2023-12,633,225,311,97,621,12
10467,2024-01,695,241,330,124,685,10
10467,2024-02,620,230,295,95,609,11
10467,2024-03,648,212,333,103,632,16
10467,2024-04,570,220,275,75,558,12
10467,2024-05,697,251,326,120,686,11
10467,2024-06,693,245,333,115,686,7
10467,2024-07,674,296,278,100,661,13
10467,2024-08,695,289,301,105,680,15
10467,2024-09,739,255,390,94,728,11
10467,2024-10,666,265,292,109,654,12
10467,2024-11,608,205,310,93,596,12
10467,2024-12,588,190,300,98,586,2
10468,2020-01,365,124,197,44,356,9
10468,2020-02,352,140,172,40,348,4
10468,2020-03,368,108,195,65,359,9
10468,2020-04,317,103,180,34,313,4
10468,2020-05,372,93,221,58,369,3
10468,2020-06,403,175,185,43,398,5
10468,2020-07,397,128,203,66,393,4
10468,2020-08,379,130,206,43,377,2
10468,2020-09,372,147,167,58,364,8
10468,2020-10,419,151,219,49,412,7
10468,2020-11,349,109,191,49,342,7
10468,2020-12,360,117,196,47,357,3
10468,2021-01,350,136,171,43,348,2
10468,2021-02,259,84,133,42,259,0
10468,2021-03,319,90,172,57,317,2
10468,2021-04,282,106,122,54,280,2
10468,2021-05,337,116,160,61,330,7
10468,2021-06,346,122,149,75,346,0
10468,2021-07,384,149,181,54,375,9
10468,2021-08,407,146,200,61,404,3
10468,2021-09,335,125,162,48,330,5
10468,2021-10,386,148,176,62,383,3
10468,2021-11,363,141,166,56,361,2
10468,2021-12,342,143,141,58,338,4
10468,2022-01,344,113,186,45,337,7
10468,2022-02,288,117,124,47,284,4
10468,2022-03,363,126,172,65,359,4
10468,2022-04,377,130,186,61,374,3
10468,2022-05,420,154,188,78,416,4
10468,2022-06,391,140,192,59,381,10
10468,2022-07,401,153,205,43,393,8
10468,2022-08,394,151,190,53,388,6
10468,2022-09,379,144,172,63,377,2
10468,2022-10,376,137,178,61,368,8
10468,2022-11,395,124,203,68,391,4
10468,2022-12,355,123,184,48,353,2
10468,2023-01,371,143,171,57,367,4
10468,2023-02,308,116,150,42,301,7
10468,2023-03,368,140,155,73,363,5
10468,2023-04,388,139,191,58,383,5
10468,2023-05,443,179,211,53,437,6
10468,2023-06,389,140,187,62,382,7
10468,2023-07,433,174,189,70,424,9
10468,2023-08,402,150,185,67,395,7
10468,2023-09,373,129,179,65,369,4
10468,2023-10,457,183,199,75,450,7
10468,2023-11,396,150,187,59,395,1
10468,2023-12,472,172,233,67,464,8
10468,2024-01,461,176,225,60,453,8
10468,2024-02,449,159,215,75,437,12
10468,2024-03,405,159,195,51,395,10
10468,2024-04,421,157,200,64,415,6
10468,2024-05,406,149,200,57,402,4
10468,2024-06,439,181,185,73,434,5
10468,2024-07,506,195,243,68,504,2
10468,2024-08,491,209,212,70,484,7
10468,2024-09,473,191,211,71,461,12
10468,2024-10,518,194,238,86,511,7
10468,2024-11,471,150,235,86,468,3
10468,2024-12,401,132,221,48,395,6
10469,2020-01,245,67,131,47,238,7
10469,2020-02,238,57,145,36,236,2
10469,2020-03,236,69,129,38,232,4
10469,2020-04,207,61,117,29,204,3
10469,2020-05,256,68,128,60,253,3
10469,2020-06,269,77,148,44,264,5
10469,2020-07,247,61,130,56,242,5
10469,2020-08,250,72,126,52,247,3
10469,2020-09,274,95,127,52,270,4
10469,2020-10,302,92,156,54,298,4
10469,2020-11,310,95,173,42,306,4
10469,2020-12,291,102,142,47,284,7
10469,2021-01,296,92,167,37,293,3
10469,2021-02,235,69,121,45,233,2
10469,2021-03,273,99,120,54,271,2
10469,2021-04,239,95,114,30,230,9
10469,2021-05,296,100,137,59,290,6
10469,2021-06,300,104,144,52,294,6
10469,2021-07,271,95,122,54,269,2
10469,2021-08,278,95,135,48,275,3
10469,2021-09,308,116,140,52,304,4
10469,2021-10,358,112,173,73,349,9
10469,2021-11,316,112,142,62,313,3
10469,2021-12,300,112,124,64,296,4
10469,2022-01,318,110,146,62,311,7
10469,2022-02,271,105,122,44,267,4
10469,2022-03,341,102,183,56,337,4
10469,2022-04,282,88,147,47,274,8
10469,2022-05,339,105,149,85,334,5
10469,2022-06,382,105,206,71,375,7
10469,2022-07,348,121,160,67,344,4
10469,2022-08,356,105,187,64,354,2
10469,2022-09,325,95,156,74,318,7
10469,2022-10,335,121,139,75,330,5
10469,2022-11,350,122,159,69,341,9
10469,2022-12,289,105,140,44,285,4
10469,2023-01,350,128,157,65,341,9
10469,2023-02,287,98,147,42,280,7
10469,2023-03,322,122,149,51,317,5
10469,2023-04,328,126,160,42,317,11
10469,2023-05,409,161,176,72,396,13
10469,2023-06,366,136,169,61,357,9
10469,2023-07,354,136,165,53,347,7
10469,2023-08,358,158,131,69,350,8
10469,2023-09,305,124,121,60,299,6
10469,2023-10,322,141,138,43,310,12
10469,2023-11,325,135,148,42,318,7
10469,2023-12,330,131,159,40,325,5
10469,2024-01,329,131,160,38,324,5
10469,2024-02,304,107,140,57,303,1
10469,2024-03,283,103,126,54,277,6
10469,2024-04,273,118,110,45,263,10
10469,2024-05,374,142,169,63,370,4
10469,2024-06,375,151,181,43,366,9
10469,2024-07,376,142,167,67,369,7
10469,2024-08,340,132,155,53,335,5
10469,2024-09,337,146,141,50,330,7
10469,2024-10,350,133,156,61,347,3
10469,2024-11,330,112,152,66,326,4
10469,2024-12,339,155,136,48,328,11
10470,2020-01,75,23,46,6,74,1
10470,2020-02,99,27,52,20,96,3
10470,2020-03,62,13,37,12,62,0
10470,2020-04,44,13,27,4,43,1
10470,2020-05,55,18,28,9,53,2
10470,2020-06,64,17,34,13,63,1
10470,2020-07,85,17,47,21,85,0
10470,2020-08,98,36,47,15,98,0
10470,2020-09,83,28,40,15,82,1
10470,2020-10,86,26,47,13,82,4
10470,2020-11,72,22,42,8,71,1
10470,2020-12,78,17,50,11,77,1
10470,2021-01,78,29,37,12,74,4
10470,2021-02,62,20,30,12,61,1
10470,2021-03,57,15,31,11,56,1
10470,2021-04,67,22,34,11,65,2
10470,2021-05,93,29,44,20,93,0
10470,2021-06,74,22,43,9,72,2
10470,2021-07,103,39,49,15,100,3
10470,2021-08,107,38,55,14,107,0
10470,2021-09,89,34,45,10,87,2
10470,2021-10,91,27,46,18,91,0
10470,2021-11,100,31,54,15,100,0
10470,2021-12,86,27,46,13,86,0
10470,2022-01,100,30,49,21,100,0
10470,2022-02,91,32,42,17,91,0
10470,2022-03,104,45,40,19,101,3
10470,2022-04,95,41,35,19,95,0
10470,2022-05,103,34,46,23,102,1
10470,2022-06,117,48,50,19,115,2
10470,2022-07,111,49,47,15,109,2
10470,2022-08,103,36,52,15,102,1
10470,2022-09,80,26,42,12,78,2
10470,2022-10,102,36,47,19,102,0
10470,2022-11,94,47,29,18,94,0
10470,2022-12,88,31,33,24,86,2
10470,2023-01,107,49,42,16,103,4
10470,2023-02,79,31,34,14,77,2
10470,2023-03,90,35,39,16,85,5
10470,2023-04,99,45,38,16,96,3
10470,2023-05,136,54,63,19,136,0
10470,2023-06,97,39,42,16,96,1
10470,2023-07,86,32,44,10,85,1
10470,2023-08,87,39,31,17,86,1
10470,2023-09,101,46,38,17,99,2
10470,2023-10,111,47,50,14,110,1
10470,2023-11,104,36,56,12,102,2
10470,2023-12,109,49,47,13,109,0
10470,2024-01,96,43,45,8,94,2
10470,2024-02,78,28,40,10,75,3
10470,2024-03,86,34,41,11,82,4
10470,2024-04,118,50,51,17,117,1
10470,2024-05,105,45,45,15,102,3
10470,2024-06,97,45,40,12,96,1
10470,2024-07,134,66,52,16,129,5
10470,2024-08,109,49,47,13,108,1
10470,2024-09,114,52,48,14,112,2
10470,2024-10,101,47,37,17,98,3
10470,2024-11,102,48,44,10,98,4
10470,2024-12,126,43,63,20,125,1
10471,2020-01,59,25,25,9,59,0
10471,2020-02,58,24,24,10,57,1
10471,2020-03,43,16,18,9,43,0
10471,2020-04,46,13,29,4,46,0
10471,2020-05,62,17,38,7,61,1
10471,2020-06,46,16,22,8,46,0
10471,2020-07,55,21,23,11,55,0
10471,2020-08,49,22,13,14,49,0
10471,2020-09,55,17,26,12,54,1
10471,2020-10,61,20,34,7,61,0
10471,2020-11,53,14,33,6,52,1
10471,2020-12,54,17,26,11,53,1
10471,2021-01,43,16,21,6,42,1
10471,2021-02,43,18,17,8,41,2
10471,2021-03,51,13,26,12,50,1
10471,2021-04,55,18,27,10,55,0
10471,2021-05,49,15,24,10,49,0
10471,2021-06,48,20,23,5,48,0
10471,2021-07,42,16,19,7,40,2
10471,2021-08,45,10,25,10,45,0
10471,2021-09,52,14,27,11,51,1
10471,2021-10,69,26,27,16,66,3
10471,2021-11,67,23,31,13,66,1
10471,2021-12,66,26,27,13,65,1
10471,2022-01,54,25,23,6,50,4
10471,2022-02,60,28,26,6,59,1
10471,2022-03,74,24,34,16,72,2
10471,2022-04,72,31,30,11,70,2
10471,2022-05,76,29,34,13,75,1
10471,2022-06,69,32,26,11,69,0
10471,2022-07,63,26,22,15,60,3
10471,2022-08,71,31,29,11,69,2
10471,2022-09,73,28,28,17,72,1
10471,2022-10,95,33,44,18,91,4
10471,2022-11,84,42,28,14,82,2
10471,2022-12,74,35,32,7,72,2
10471,2023-01,56,23,23,10,55,1
10471,2023-02,54,19,29,6,50,4
10471,2023-03,63,25,28,10,62,1
10471,2023-04,72,25,30,17,71,1
10471,2023-05,84,34,33,17,81,3
10471,2023-06,84,39,28,17,83,1
10471,2023-07,77,37,20,20,75,2
10471,2023-08,87,30,38,19,86,1
10471,2023-09,66,23,29,14,66,0
10471,2023-10,84,25,34,25,83,1
10471,2023-11,88,33,36,19,87,1
10471,2023-12,119,55,50,14,115,4
10471,2024-01,93,39,36,18,92,1
10471,2024-02,64,27,21,16,64,0
10471,2024-03,66,27,26,13,65,1
10471,2024-04,71,33,31,7,71,0
10471,2024-05,96,33,32,31,93,3
10471,2024-06,85,34,36,15,85,0
10471,2024-07,88,38,35,15,85,3
10471,2024-08,70,32,26,12,68,2
10471,2024-09,58,21,28,9,56,2
10471,2024-10,87,43,36,8,86,1
10471,2024-11,57,27,22,8,54,3
10471,2024-12,51,17,23,11,50,1
10472,2020-01,314,102,153,59,311,3
10472,2020-02,308,112,151,45,304,4
10472,2020-03,290,95,145,50,287,3
10472,2020-04,248,79,130,39,243,5
10472,2020-05,336,106,173,57,333,3
10472,2020-06,258,88,112,58,255,3
10472,2020-07,308,118,128,62,306,2
10472,2020-08,364,119,167,78,357,7
10472,2020-09,321,121,145,55,317,4
10472,2020-10,311,123,129,59,307,4
10472,2020-11,327,130,162,35,322,5
10472,2020-12,328,133,129,66,324,4
10472,2021-01,266,95,125,46,261,5
10472,2021-02,293,106,130,57,291,2
10472,2021-03,288,104,138,46,280,8
10472,2021-04,314,115,130,69,306,8
10472,2021-05,346,133,144,69,341,5
10472,2021-06,371,124,176,71,363,8
10472,2021-07,431,149,201,81,423,8
10472,2021-08,353,137,154,62,340,13
10472,2021-09,413,156,179,78,407,6
10472,2021-10,448,188,194,66,435,13
10472,2021-11,413,152,195,66,403,10
10472,2021-12,392,179,156,57,386,6
10472,2022-01,397,142,186,69,391,6
10472,2022-02,351,128,142,81,338,13
10472,2022-03,412,147,198,67,407,5
10472,2022-04,453,141,228,84,445,8
10472,2022-05,433,162,208,63,419,14
10472,2022-06,453,180,193,80,438,15
10472,2022-07,477,184,213,80,458,19
10472,2022-08,430,160,186,84,421,9
10472,2022-09,436,176,181,79,424,12
10472,2022-10,438,158,208,72,432,6
10472,2022-11,461,180,215,66,447,14
10472,2022-12,387,163,154,70,380,7
10472,2023-01,451,174,212,65,445,6
10472,2023-02,393,147,181,65,386,7
10472,2023-03,400,138,184,78,395,5
10472,2023-04,376,152,159,65,366,10
10472,2023-05,411,153,184,74,402,9
10472,2023-06,447,156,206,85,444,3
10472,2023-07,416,166,174,76,407,9
10472,2023-08,417,177,175,65,407,10
10472,2023-09,364,142,164,58,357,7
10472,2023-10,373,121,191,61,368,5
10472,2023-11,420,159,192,69,410,10
10472,2023-12,430,151,220,59,422,8
10472,2024-01,376,145,171,60,371,5
10472,2024-02,368,114,195,59,364,4
10472,2024-03,450,157,236,57,442,8
10472,2024-04,338,138,156,44,335,3
10472,2024-05,416,136,213,67,410,6
10472,2024-06,402,155,188,59,391,11
10472,2024-07,414,148,205,61,407,7
10472,2024-08,395,153,196,46,389,6
10472,2024-09,406,144,202,60,402,4
10472,2024-10,473,189,222,62,470,3
10472,2024-11,399,144,184,71,393,6
10472,2024-12,321,121,145,55,312,9
10473,2020-01,331,105,159,67,328,3
10473,2020-02,324,97,150,77,321,3
10473,2020-03,279,68,158,53,273,6
10473,2020-04,240,66,114,60,238,2
10473,2020-05,261,73,135,53,258,3
10473,2020-06,290,89,138,63,286,4
10473,2020-07,314,96,150,68,312,2
10473,2020-08,339,110,167,62,336,3
10473,2020-09,297,102,134,61,293,4
10473,2020-10,333,122,151,60,330,3
10473,2020-11,306,111,146,49,298,8
10473,2020-12,305,110,136,59,301,4
10473,2021-01,238,75,121,42,234,4
10473,2021-02,244,69,122,53,240,4
10473,2021-03,284,89,142,53,279,5
10473,2021-04,262,89,118,55,259,3
10473,2021-05,327,118,159,50,326,1
10473,2021-06,313,99,162,52,307,6
10473,2021-07,359,136,166,57,353,6
10473,2021-08,363,132,161,70,358,5
10473,2021-09,335,110,147,78,326,9
10473,2021-10,355,131,158,66,352,3
10473,2021-11,370,125,172,73,361,9
10473,2021-12,406,121,203,82,404,2
10473,2022-01,338,115,162,61,334,4
10473,2022-02,336,106,157,73,332,4
10473,2022-03,397,136,188,73,390,7
10473,2022-04,361,119,184,58,353,8
10473,2022-05,419,140,200,79,407,12
10473,2022-06,371,124,162,85,361,10
10473,2022-07,395,142,178,75,391,4
10473,2022-08,452,149,215,88,446,6
10473,2022-09,458,154,232,72,454,4
10473,2022-10,451,154,212,85,438,13
10473,2022-11,423,149,216,58,413,10
10473,2022-12,405,143,193,69,399,6
10473,2023-01,422,156,205,61,412,10
10473,2023-02,387,106,204,77,376,11
10473,2023-03,416,143,201,72,408,8
10473,2023-04,415,138,191,86,406,9
10473,2023-05,512,160,270,82,501,11
10473,2023-06,458,152,236,70,448,10
10473,2023-07,418,150,196,72,412,6
10473,2023-08,459,159,227,73,455,4
10473,2023-09,326,111,152,63,321,5
10473,2023-10,394,131,203,60,386,8
10473,2023-11,358,130,153,75,353,5
10473,2023-12,397,116,215,66,395,2
10473,2024-01,415,133,214,68,405,10
10473,2024-02,381,126,199,56,373,8
10473,2024-03,388,104,195,89,383,5
10473,2024-04,331,112,167,52,326,5
10473,2024-05,384,131,199,54,379,5
10473,2024-06,425,144,202,79,415,10
10473,2024-07,432,185,182,65,425,7
10473,2024-08,398,138,207,53,394,4
10473,2024-09,381,130,197,54,375,6
10473,2024-10,390,151,175,64,388,2
10473,2024-11,345,113,163,69,341,4
10473,2024-12,328,93,172,63,321,7
10474,2020-01,180,64,89,27,178,2
10474,2020-02,147,47,75,25,145,2
10474,2020-03,154,53,89,12,151,3
10474,2020-04,93,44,43,6,91,2
10474,2020-05,177,58,94,25,176,1
10474,2020-06,91,25,52,14,89,2
10474,2020-07,135,39,78,18,133,2
10474,2020-08,168,41,108,19,166,2
10474,2020-09,154,53,82,19,153,1
10474,2020-10,192,59,104,29,188,4
10474,2020-11,193,46,125,22,190,3
10474,2020-12,125,47,56,22,125,0
10474,2021-01,113,34,52,27,113,0
10474,2021-02,110,38,53,19,109,1
10474,2021-03,146,57,74,15,145,1
10474,2021-04,101,34,47,20,95,5
10474,2021-05,112,46,51,15,109,3
10474,2021-06,122,45,64,13,121,1
10474,2021-07,169,58,77,34,168,1
10474,2021-08,143,54,65,24,142,1
10474,2021-09,165,55,82,28,164,1
10474,2021-10,151,73,55,23,150,1
10474,2021-11,142,52,64,26,140,2
10474,2021-12,138,59,56,23,135,3
10474,2022-01,136,57,56,23,136,0
10474,2022-02,123,57,52,14,119,4
10474,2022-03,179,69,81,29,175,4
10474,2022-04,207,88,88,31,205,2
10474,2022-05,177,66,82,29,173,4
10474,2022-06,202,79,86,37,200,2
10474,2022-07,212,89,97,26,206,6
10474,2022-08,183,72,88,23,182,1
10474,2022-09,178,78,70,30,176,2
10474,2022-10,194,86,85,23,190,4
10474,2022-11,189,86,82,21,184,5
10474,2022-12,187,93,66,28,182,5
10474,2023-01,210,88,88,34,209,1
10474,2023-02,178,76,74,28,173,5
10474,2023-03,168,69,78,21,163,5
10474,2023-04,192,89,83,20,191,1
10474,2023-05,197,80,87,30,192,5
10474,2023-06,218,89,95,34,216,2
10474,2023-07,311,134,142,35,304,7
10474,2023-08,225,99,106,20,212,13
10474,2023-09,188,77,89,22,183,5
10474,2023-10,218,84,107,27,207,11
10474,2023-11,200,75,98,27,193,7
10474,2023-12,188,72,95,21,183,5
10474,2024-01,217,84,116,17,216,1
10474,2024-02,191,72,96,23,185,6
10474,2024-03,205,81,105,19,202,3
10474,2024-04,249,93,124,32,245,4
10474,2024-05,267,97,132,38,259,8
10474,2024-06,228,98,110,20,226,2
10474,2024-07,248,91,129,28,238,10
10474,2024-08,243,84,125,34,239,4
10474,2024-09,223,83,109,31,220,3
10474,2024-10,237,84,130,23,234,3
10474,2024-11,207,74,106,27,203,4
10474,2024-12,181,65,97,19,179,2
10475,2020-01,176,43,94,39,176,0
10475,2020-02,145,49,81,15,143,2
10475,2020-03,170,46,95,29,169,1
10475,2020-04,100,30,49,21,100,0
10475,2020-05,108,31,55,22,105,3
10475,2020-06,118,21,66,31,115,3
10475,2020-07,135,23,78,34,133,2
10475,2020-08,108,29,58,21,107,1
10475,2020-09,111,33,45,33,110,1
10475,2020-10,97,30,46,21,96,1
10475,2020-11,122,36,68,18,118,4
10475,2020-12,134,42,71,21,133,1
10475,2021-01,123,44,62,17,122,1
10475,2021-02,111,37,53,21,109,2
10475,2021-03,168,45,97,26,164,4
10475,2021-04,121,48,51,22,116,5
10475,2021-05,144,47,74,23,139,5
10475,2021-06,148,48,73,27,146,2
10475,2021-07,144,45,73,26,144,0
10475,2021-08,153,50,74,29,152,1
10475,2021-09,131,53,65,13,127,4
10475,2021-10,158,58,78,22,156,2
10475,2021-11,158,59,82,17,155,3
10475,2021-12,139,41,72,26,137,2
10475,2022-01,148,46,73,29,146,2
10475,2022-02,122,37,67,18,122,0
10475,2022-03,145,46,78,21,143,2
10475,2022-04,136,36,75,25,132,4
10475,2022-05,143,42,76,25,140,3
10475,2022-06,138,52,64,22,138,0
10475,2022-07,133,47,61,25,131,2
10475,2022-08,159,61,70,28,153,6
10475,2022-09,147,61,65,21,145,2
10475,2022-10,171,57,82,32,168,3
10475,2022-11,183,60,95,28,181,2
10475,2022-12,150,56,75,19,149,1
10475,2023-01,153,64,65,24,149,4
10475,2023-02,150,43,90,17,150,0
10475,2023-03,175,68,87,20,170,5
10475,2023-04,173,61,90,22,171,2
10475,2023-05,215,69,115,31,211,4
10475,2023-06,174,70,89,15,160,14
10475,2023-07,176,70,78,28,172,4
10475,2023-08,188,67,102,19,185,3
10475,2023-09,151,44,89,18,150,1
10475,2023-10,160,52,88,20,158,2
10475,2023-11,184,58,88,38,182,2
10475,2023-12,191,59,91,41,190,1
10475,2024-01,174,62,82,30,171,3
10475,2024-02,178,48,103,27,175,3
10475,2024-03,177,63,81,33,173,4
10475,2024-04,135,45,65,25,134,1
10475,2024-05,172,62,83,27,168,4
10475,2024-06,140,50,70,20,137,3
10475,2024-07,163,68,67,28,163,0
10475,2024-08,154,62,77,15,153,1
10475,2024-09,150,59,66,25,146,4
10475,2024-10,156,72,64,20,152,4
10475,2024-11,110,42,47,21,110,0
10475,2024-12,105,42,46,17,104,1
11004,2020-01,34,14,10,10,34,0
11004,2020-02,24,5,14,5,24,0
11004,2020-03,19,7,9,3,19,0
11004,2020-04,18,9,6,3,18,0
11004,2020-05,29,7,17,5,28,1
11004,2020-06,25,9,9,7,25,0
11004,2020-07,23,9,9,5,22,1
11004,2020-08,33,8,19,6,33,0
11004,2020-09,31,8,18,5,31,0
11004,2020-10,44,12,25,7,44,0
11004,2020-11,36,11,16,9,36,0
11004,2020-12,32,9,15,8,31,1
11004,2021-01,27,8,12,7,26,1
11004,2021-02,24,11,9,4,23,1
11004,2021-03,44,18,18,8,44,0
11004,2021-04,34,13,14,7,33,1
11004,2021-05,41,14,20,7,40,1
11004,2021-06,46,14,23,9,46,0
11004,2021-07,32,15,12,5,31,1
11004,2021-08,38,15,19,4,37,1
11004,2021-09,44,15,23,6,43,1
11004,2021-10,45,10,27,8,45,0
11004,2021-11,48,16,24,8,46,2
11004,2021-12,34,12,17,5,32,2
11004,2022-01,31,10,14,7,30,1
11004,2022-02,23,12,9,2,23,0
11004,2022-03,43,13,26,4,42,1
11004,2022-04,45,10,16,19,44,1
11004,2022-05,31,9,17,5,31,0
11004,2022-06,43,19,19,5,41,2
11004,2022-07,42,17,19,6,42,0
11004,2022-08,63,17,30,16,63,0
11004,2022-09,43,8,22,13,42,1
11004,2022-10,33,9,14,10,33,0
11004,2022-11,37,15,10,12,36,1
11004,2022-12,30,10,15,5,30,0
11004,2023-01,25,7,12,6,25,0
11004,2023-02,35,10,19,6,34,1
11004,2023-03,29,10,10,9,29,0
11004,2023-04,40,16,15,9,39,1
11004,2023-05,55,16,23,16,54,1
11004,2023-06,42,18,16,8,42,0
11004,2023-07,51,11,29,11,51,0
11004,2023-08,50,13,21,16,48,2
11004,2023-09,35,11,17,7,35,0
11004,2023-10,55,15,24,16,55,0
11004,2023-11,36,14,17,5,36,0
11004,2023-12,46,16,24,6,46,0
11004,2024-01,38,13,16,9,37,1
11004,2024-02,45,18,20,7,44,1
11004,2024-03,44,14,25,5,44,0
11004,2024-04,44,17,17,10,43,1
11004,2024-05,46,12,27,7,45,1
11004,2024-06,50,10,31,9,50,0
11004,2024-07,54,16,29,9,54,0
11004,2024-08,38,14,20,4,38,0
11004,2024-09,46,13,29,4,46,0
11004,2024-10,40,14,20,6,39,1
11004,2024-11,33,17,11,5,33,0
11004,2024-12,34,10,18,6,34,0
11101,2020-01,269,73,134,62,267,2
11101,2020-02,264,87,131,46,258,6
11101,2020-03,247,89,122,36,246,1
11101,2020-04,175,49,100,26,172,3
11101,2020-05,246,73,132,41,244,2
11101,2020-06,302,94,155,53,298,4
11101,2020-07,326,117,156,53,321,5
11101,2020-08,370,131,173,66,362,8
11101,2020-09,316,107,153,56,310,6
11101,2020-10,334,132,156,46,329,5
11101,2020-11,293,87,149,57,290,3
11101,2020-12,289,97,138,54,284,5
11101,2021-01,324,111,177,36,318,6
11101,2021-02,267,89,135,43,264,3
11101,2021-03,349,95,187,67,347,2
11101,2021-04,370,113,180,77,365,5
11101,2021-05,363,99,192,72,360,3
11101,2021-06,376,127,185,64,373,3
11101,2021-07,399,104,200,95,392,7
11101,2021-08,395,117,207,71,386,9
11101,2021-09,358,112,180,66,356,2
11101,2021-10,426,122,220,84,418,8
11101,2021-11,341,118,167,56,338,3
11101,2021-12,341,106,182,53,340,1
11101,2022-01,338,110,154,74,334,4
11101,2022-02,374,99,191,84,366,8
11101,2022-03,446,151,216,79,442,4
11101,2022-04,425,138,206,81,417,8
11101,2022-05,440,139,220,81,435,5
11101,2022-06,438,140,230,68,434,4
11101,2022-07,499,157,266,76,495,4
11101,2022-08,482,147,259,76,479,3
11101,2022-09,437,141,230,66,433,4
11101,2022-10,433,139,234,60,429,4
11101,2022-11,395,134,190,71,393,2
11101,2022-12,365,125,174,66,359,6
11101,2023-01,335,112,168,55,331,4
11101,2023-02,364,116,187,61,357,7
11101,2023-03,376,125,173,78,368,8
11101,2023-04,375,120,181,74,372,3
11101,2023-05,473,120,256,97,467,6
11101,2023-06,515,150,296,69,511,4
11101,2023-07,509,163,271,75,503,6
11101,2023-08,567,165,310,92,556,11
11101,2023-09,468,151,241,76,461,7
11101,2023-10,534,145,319,70,528,6
11101,2023-11,553,171,294,88,546,7
11101,2023-12,494,141,288,65,490,4
11101,2024-01,488,132,270,86,484,4
11101,2024-02,485,136,280,69,480,5
11101,2024-03,493,142,273,78,490,3
11101,2024-04,466,131,269,66,459,7
11101,2024-05,521,153,278,90,516,5
11101,2024-06,570,172,318,80,563,7
11101,2024-07,526,132,315,79,521,5
11101,2024-08,548,160,319,69,544,4
11101,2024-09,509,139,291,79,501,8
11101,2024-10,503,146,267,90,493,10
11101,2024-11,482,139,265,78,478,4
11101,2024-12,430,109,260,61,427,3
11102,2020-01,112,44,49,19,110,2
11102,2020-02,112,32,66,14,109,3
11102,2020-03,79,27,38,14,77,2
11102,2020-04,88,29,40,19,85,3
11102,2020-05,92,37,41,14,89,3
11102,2020-06,89,27,40,22,88,1
11102,2020-07,113,38,58,17,113,0
11102,2020-08,116,35,52,29,114,2
11102,2020-09,130,41,59,30,125,5
11102,2020-10,157,53,72,32,155,2
11102,2020-11,154,42,80,32,151,3
11102,2020-12,115,36,51,28,114,1
11102,2021-01,133,43,72,18,130,3
11102,2021-02,110,42,49,19,106,4
11102,2021-03,101,38,43,20,100,1
11102,2021-04,103,30,54,19,101,1
11102,2021-05,116,40,52,24,114,2
11102,2021-06,119,37,56,26,118,1
11102,2021-07,143,43,72,28,141,2
11102,2021-08,158,56,72,30,155,3
11102,2021-09,138,36,69,33,138,0
11102,2021-10,138,41,70,27,137,1
11102,2021-11,132,48,55,29,131,1
11102,2021-12,143,47,65,31,142,1
11102,2022-01,138,44,66,28,136,2
11102,2022-02,94,31,41,22,91,3
11102,2022-03,132,44,63,25,131,1
11102,2022-04,130,33,63,34,128,2
11102,2022-05,128,31,60,37,127,1
11102,2022-06,138,51,61,26,137,1
11102,2022-07,132,43,70,19,129,3
11102,2022-08,156,53,80,23,154,2
11102,2022-09,115,40,52,23,114,1
11102,2022-10,123,45,56,22,122,1
11102,2022-11,137,49,61,27,133,4
11102,2022-12,109,50,37,22,99,10
11102,2023-01,119,42,55,22,119,0
11102,2023-02,102,32,50,20,102,0
11102,2023-03,138,38,68,32,136,2
11102,2023-04,98,30,51,17,96,2
11102,2023-05,132,37,69,26,130,2
11102,2023-06,126,41,61,24,123,3
11102,2023-07,130,39,60,31,127,3
11102,2023-08,128,32,71,25,124,4
11102,2023-09,118,43,51,24,117,1
11102,2023-10,126,33,60,33,125,1
11102,2023-11,124,36,62,26,122,2
11102,2023-12,115,34,57,24,115,0
11102,2024-01,115,40,45,30,111,4
11102,2024-02,126,43,60,23,125,1
11102,2024-03,115,33,60,22,115,0
11102,2024-04,110,40,42,28,109,1
11102,2024-05,131,41,59,31,131,0
11102,2024-06,170,56,71,43,167,3
11102,2024-07,144,55,55,34,143,1
11102,2024-08,150,39,73,38,147,3
11102,2024-09,132,45,63,24,132,0
11102,2024-10,126,40,60,26,122,4
11102,2024-11,96,27,48,21,95,1
11102,2024-12,112,31,59,22,110,2
11103,2020-01,165,54,95,16,163,2
11103,2020-02,144,40,85,19,144,0
11103,2020-03,110,28,67,15,109,1
11103,2020-04,90,29,53,8,89,1
11103,2020-05,100,26,57,17,98,2
11103,2020-06,154,41,90,23,152,2
11103,2020-07,151,44,83,24,149,2
11103,2020-08,168,46,95,27,165,3
11103,2020-09,207,60,123,24,204,3
11103,2020-10,194,63,93,38,192,2
11103,2020-11,160,46,87,27,155,5
11103,2020-12,155,50,79,26,153,2
11103,2021-01,138,37,86,15,134,4
11103,2021-02,129,46,61,22,127,2
11103,2021-03,160,40,102,18,157,2
11103,2021-04,149,46,80,23,149,0
11103,2021-05,172,35,114,23,169,3
11103,2021-06,154,46,89,19,153,1
11103,2021-07,161,38,102,21,161,0
11103,2021-08,190,53,105,32,187,3
11103,2021-09,182,46,111,25,179,3
11103,2021-10,245,62,147,36,241,4
11103,2021-11,190,73,95,22,188,2
11103,2021-12,207,79,103,25,203,4
11103,2022-01,183,50,115,18,181,2
11103,2022-02,148,50,81,17,146,2
11103,2022-03,194,52,106,36,190,4
11103,2022-04,206,73,99,34,202,4
11103,2022-05,220,65,122,33,217,3
11103,2022-06,248,85,129,34,246,2
11103,2022-07,254,69,139,46,251,3
11103,2022-08,229,59,148,22,228,1
11103,2022-09,215,60,128,27,213,2
11103,2022-10,185,58,106,21,182,3
11103,2022-11,201,54,115,32,199,2
11103,2022-12,186,61,104,21,184,2
11103,2023-01,204,62,109,33,201,3
11103,2023-02,219,52,144,23,217,2
11103,2023-03,210,63,119,28,208,2
11103,2023-04,185,54,111,20,182,3
11103,2023-05,236,65,135,36,235,1
11103,2023-06,177,49,101,27,175,2
11103,2023-07,203,62,112,29,200,3
11103,2023-08,211,68,118,25,211,0
11103,2023-09,192,58,99,35,189,3
11103,2023-10,199,66,109,24,198,1
11103,2023-11,185,64,103,18,184,1
11103,2023-12,165,50,92,23,164,1
11103,2024-01,193,53,116,24,190,3
11103,2024-02,184,66,85,33,177,7
11103,2024-03,215,70,120,25,212,3
11103,2024-04,194,55,112,27,192,2
11103,2024-05,185,53,110,22,182,3
11103,2024-06,221,75,118,28,220,1
11103,2024-07,191,67,100,24,184,7
11103,2024-08,213,52,142,19,211,2
11103,2024-09,186,34,126,26,186,0
11103,2024-10,204,47,126,31,200,4
11103,2024-11,155,51,77,27,152,3
11103,2024-12,136,39,77,20,135,1
11104,2020-01,90,31,34,25,87,3
11104,2020-02,66,13,33,20,65,1
11104,2020-03,60,21,30,9,60,0
11104,2020-04,56,26,20,10,55,1
11104,2020-05,65,23,24,18,63,2
11104,2020-06,64,8,39,17,64,0
11104,2020-07,61,17,31,13,61,0
11104,2020-08,84,27,41,16,84,0
11104,2020-09,82,30,38,14,82,0
11104,2020-10,72,20,41,11,72,0
11104,2020-11,59,16,31,12,57,2
11104,2020-12,64,11,40,13,63,1
11104,2021-01,85,18,48,19,84,1
11104,2021-02,42,7,27,8,42,0
11104,2021-03,70,22,37,11,70,0
11104,2021-04,57,14,33,10,57,0
11104,2021-05,98,30,55,13,97,1
11104,2021-06,75,18,43,14,74,1
11104,2021-07,68,16,38,14,67,1
11104,2021-08,89,24,56,9,89,0
11104,2021-09,89,10,56,23,88,1
11104,2021-10,87,20,52,15,87,0
11104,2021-11,72,24,35,13,72,0
11104,2021-12,63,27,31,5,63,0
11104,2022-01,65,25,28,12,64,1
11104,2022-02,82,21,53,8,79,3
11104,2022-03,85,22,47,16,85,0
11104,2022-04,68,18,34,16,67,1
11104,2022-05,78,23,38,17,78,0
11104,2022-06,81,28,32,21,81,0
11104,2022-07,75,23,38,14,75,0
11104,2022-08,72,23,32,17,69,3
11104,2022-09,80,18,42,20,80,0
11104,2022-10,86,25,42,19,86,0
11104,2022-11,87,27,41,19,86,1
11104,2022-12,55,19,26,10,54,1
11104,2023-01,64,23,25,16,63,1
11104,2023-02,76,23,34,19,74,2
11104,2023-03,82,29,41,12,81,1
11104,2023-04,83,31,34,18,82,1
11104,2023-05,103,36,47,20,101,2
11104,2023-06,70,20,35,15,69,1
11104,2023-07,90,33,46,11,90,0
11104,2023-08,81,27,41,13,80,1
11104,2023-09,103,41,48,14,103,0
11104,2023-10,75,25,34,16,74,1
11104,2023-11,75,20,42,13,75,0
11104,2023-12,97,40,47,10,92,5
11104,2024-01,93,32,50,11,91,2
11104,2024-02,75,23,39,13,74,1
11104,2024-03,86,26,50,10,84,2
11104,2024-04,64,21,31,12,64,0
11104,2024-05,90,29,47,14,87,3
11104,2024-06,103,27,58,18,102,1
11104,2024-07,113,30,60,23,112,1
11104,2024-08,106,44,50,12,102,4
11104,2024-09,93,32,45,16,92,1
11104,2024-10,104,24,64,16,103,1
11104,2024-11,77,26,37,14,77,0
11104,2024-12,59,17,34,8,58,1
11105,2020-01,79,22,41,16,78,1
11105,2020-02,84,27,41,16,83,1
11105,2020-03,65,15,35,15,64,1
11105,2020-04,54,18,30,6,54,0
11105,2020-05,74,15,37,22,74,0
11105,2020-06,106,23,63,20,106,0
11105,2020-07,79,22,40,17,79,0
11105,2020-08,110,24,62,24,109,1
11105,2020-09,96,26,46,24,94,2
11105,2020-10,130,35,65,30,126,4
11105,2020-11,109,39,53,17,106,3
11105,2020-12,91,33,41,17,89,2
11105,2021-01,93,14,62,17,92,1
11105,2021-02,89,13,58,18,89,0
11105,2021-03,149,40,86,23,144,5
11105,2021-04,87,23,57,7,86,1
11105,2021-05,117,38,65,14,117,0
11105,2021-06,103,30,49,24,103,0
11105,2021-07,92,23,52,17,91,1
11105,2021-08,126,35,72,19,125,1
11105,2021-09,125,33,65,27,124,1
11105,2021-10,119,30,59,30,117,2
11105,2021-11,122,31,68,23,122,0
11105,2021-12,121,38,52,31,119,2
11105,2022-01,102,21,55,26,102,0
11105,2022-02,97,28,50,19,96,1
11105,2022-03,148,45,73,30,146,2
11105,2022-04,117,34,52,31,117,0
11105,2022-05,116,39,54,23,115,1
11105,2022-06,142,49,67,26,141,1
11105,2022-07,135,40,72,23,133,2
11105,2022-08,118,34,71,13,118,0
11105,2022-09,138,40,66,32,136,2
11105,2022-10,138,45,74,19,137,1
11105,2022-11,136,44,61,31,133,3
11105,2022-12,91,32,47,12,91,0
11105,2023-01,115,31,62,22,115,0
11105,2023-02,97,32,51,14,95,2
11105,2023-03,124,43,61,20,123,1
11105,2023-04,114,48,47,19,114,0
11105,2023-05,146,51,64,31,144,2
11105,2023-06,136,48,62,26,136,0
11105,2023-07,117,39,62,16,115,2
11105,2023-08,137,58,64,15,127,10
11105,2023-09,125,47,58,20,124,1
11105,2023-10,162,58,68,36,162,0
11105,2023-11,122,36,56,30,118,4
11105,2023-12,119,39,57,23,118,1
11105,2024-01,120,31,65,24,118,2
11105,2024-02,147,40,83,24,145,2
11105,2024-03,136,48,69,19,133,3
11105,2024-04,115,43,51,21,114,1
11105,2024-05,110,32,59,19,109,1
11105,2024-06,128,42,70,16,126,2
11105,2024-07,151,51,77,23,149,2
11105,2024-08,140,34,83,23,137,3
11105,2024-09,138,50,76,12,138,0
11105,2024-10,165,50,91,24,162,3
11105,2024-11,137,38,81,18,136,1
11105,2024-12,108,32,66,10,106,2
11106,2020-01,129,35,70,24,127,2
11106,2020-02,144,40,76,28,141,3
11106,2020-03,108,25,59,24,108,0
11106,2020-04,96,23,55,18,96,0
11106,2020-05,105,29,50,26,104,1
11106,2020-06,131,36,69,26,127,4
11106,2020-07,174,39,103,32,171,3
11106,2020-08,163,49,91,23,161,2
11106,2020-09,195,56,116,23,192,3
11106,2020-10,193,57,114,22,189,4
11106,2020-11,164,38,103,23,163,1
11106,2020-12,197,46,131,20,195,2
11106,2021-01,171,35,108,28,169,2
11106,2021-02,139,32,84,23,138,1
11106,2021-03,144,42,70,32,142,2
11106,2021-04,167,38,102,27,165,2
11106,2021-05,212,48,131,33,208,4
11106,2021-06,227,48,130,49,224,3
11106,2021-07,160,42,94,24,157,3
11106,2021-08,201,57,104,40,201,0
11106,2021-09,181,48,100,33,179,2
11106,2021-10,186,57,87,42,183,3
11106,2021-11,177,46,86,45,174,3
11106,2021-12,174,65,74,35,174,0
11106,2022-01,149,44,72,33,148,1
11106,2022-02,174,47,97,30,171,3
11106,2022-03,168,40,93,35,165,3
11106,2022-04,196,42,120,34,193,3
11106,2022-05,176,42,102,32,175,1
11106,2022-06,185,59,94,32,181,4
11106,2022-07,208,48,128,32,207,1
11106,2022-08,192,66,101,25,189,3
11106,2022-09,175,50,89,36,175,0
11106,2022-10,200,57,112,31,200,0
11106,2022-11,186,71,86,29,184,2
11106,2022-12,148,45,79,24,145,3
11106,2023-01,196,49,115,32,194,2
11106,2023-02,181,39,106,36,181,0
11106,2023-03,169,40,90,39,165,4
11106,2023-04,171,48,97,26,166,5
11106,2023-05,204,50,110,44,202,2
11106,2023-06,176,39,104,33,174,2
11106,2023-07,167,52,74,41,162,5
11106,2023-08,183,60,87,36,181,2
11106,2023-09,194,49,110,35,192,2
11106,2023-10,198,58,98,42,195,3
11106,2023-11,181,41,103,37,180,1
11106,2023-12,149,45,74,30,147,2
11106,2024-01,149,52,73,24,146,3
11106,2024-02,164,52,79,33,160,4
11106,2024-03,181,54,90,37,175,6
11106,2024-04,159,49,82,28,159,0
11106,2024-05,152,46,72,34,148,4
11106,2024-06,153,66,63,24,150,3
11106,2024-07,163,54,83,26,162,1
11106,2024-08,174,62,82,30,168,6
11106,2024-09,172,51,98,23,171,1
11106,2024-10,165,49,85,31,161,4
11106,2024-11,129,45,61,23,126,3
11106,2024-12,131,39,67,25,130,1
11109,2020-01,7,2,1,4,7,0
11109,2020-02,2,1,1,0,2,0
11109,2020-03,4,0,1,3,4,0
11109,2020-04,2,0,2,0,2,0
11109,2020-05,2,0,2,0,2,0
11109,2020-06,4,2,2,0,2,2
11109,2020-07,6,1,3,2,6,0
11109,2020-08,11,3,3,5,11,0
11109,2020-09,6,3,1,2,5,1
11109,2020-10,2,1,1,0,2,0
11109,2020-11,11,1,8,2,11,0
11109,2020-12,5,3,2,0,5,0
11109,2021-01,6,3,3,0,6,0
11109,2021-02,5,2,2,1,5,0
11109,2021-03,6,2,2,2,6,0
11109,2021-04,4,1,2,1,3,1
11109,2021-05,11,4,5,2,11,0
11109,2021-06,9,1,6,2,9,0
11109,2021-07,8,5,2,1,8,0
11109,2021-08,10,1,5,4,10,0
11109,2021-09,14,5,8,1,14,0
11109,2021-10,9,0,5,4,9,0
11109,2021-11,7,4,1,2,7,0
11109,2021-12,14,4,8,2,13,1
11109,2022-01,10,1,2,7,10,0
11109,2022-02,12,4,5,3,11,1
11109,2022-03,9,5,3,1,9,0
11109,2022-04,5,2,1,2,5,0
11109,2022-05,9,5,3,1,9,0
11109,2022-06,9,4,4,1,9,0
11109,2022-07,16,3,5,8,16,0
11109,2022-08,2,0,1,1,2,0
11109,2022-09,10,5,4,1,10,0
11109,2022-10,11,4,6,1,11,0
11109,2022-11,10,5,3,2,10,0
11109,2022-12,5,2,3,0,5,0
11109,2023-01,6,1,2,3,6,0
11109,2023-02,9,5,0,4,8,1
11109,2023-03,5,3,1,1,5,0
11109,2023-04,10,7,2,1,10,0
11109,2023-05,5,0,3,2,5,0
11109,2023-06,8,3,2,3,8,0
11109,2023-07,10,2,6,2,10,0
11109,2023-08,10,5,4,1,10,0
11109,2023-09,13,7,4,2,13,0
11109,2023-10,15,2,7,6,15,0
11109,2023-11,8,3,3,2,8,0
11109,2023-12,13,7,4,2,12,1
11109,2024-01,9,5,4,0,9,0
11109,2024-02,5,3,2,0,4,1
11109,2024-03,9,7,1,1,9,0
11109,2024-04,4,1,3,0,4,0
11109,2024-05,18,8,8,2,18,0
11109,2024-06,12,5,4,3,12,0
11109,2024-07,13,5,4,4,13,0
11109,2024-08,17,7,7,3,17,0
11109,2024-09,13,6,5,2,13,0
11109,2024-10,12,3,6,3,12,0
11109,2024-11,7,1,6,0,7,0
11109,2024-12,15,5,9,1,15,0
11201,2020-01,492,170,251,71,486,6
11201,2020-02,396,106,217,73,390,6
11201,2020-03,381,111,223,47,376,5
11201,2020-04,191,53,106,32,187,4
11201,2020-05,292,113,139,40,290,2
11201,2020-06,331,104,176,51,326,5
11201,2020-07,338,121,182,35,335,3
11201,2020-08,381,139,194,48,372,9
11201,2020-09,395,128,219,48,393,2
11201,2020-10,412,143,214,55,410,2
11201,2020-11,347,130,174,43,339,8
11201,2020-12,327,102,178,47,322,5
11201,2021-01,380,133,200,47,372,8
11201,2021-02,339,106,190,43,335,4
11201,2021-03,391,107,225,59,383,7
11201,2021-04,375,95,216,64,371,4
11201,2021-05,402,124,210,68,395,7
11201,2021-06,400,108,223,69,393,7
11201,2021-07,355,122,185,48,350,5
11201,2021-08,413,152,212,49,409,4
11201,2021-09,408,134,215,59,402,6
11201,2021-10,462,150,249,63,454,8
11201,2021-11,448,149,238,61,438,10
11201,2021-12,428,141,228,59,419,9
11201,2022-01,424,141,218,65,413,11
11201,2022-02,366,113,201,52,361,5
11201,2022-03,522,148,305,69,518,4
11201,2022-04,482,143,270,69,474,8
11201,2022-05,517,150,285,82,510,7
11201,2022-06,573,179,314,80,562,11
11201,2022-07,550,155,321,74,544,6
11201,2022-08,547,148,306,93,543,4
11201,2022-09,565,135,350,80,561,4
11201,2022-10,518,146,291,81,512,6
11201,2022-11,469,120,284,65,462,7
11201,2022-12,492,146,265,81,484,8
11201,2023-01,557,174,307,76,549,8
11201,2023-02,542,147,310,85,534,8
11201,2023-03,590,162,335,93,587,3
11201,2023-04,552,159,311,82,545,7
11201,2023-05,632,195,344,93,626,6
11201,2023-06,570,175,311,84,561,9
11201,2023-07,600,168,354,78,593,7
11201,2023-08,611,184,360,67,604,7
11201,2023-09,607,174,345,88,600,7
11201,2023-10,597,161,343,93,587,10
11201,2023-11,546,144,325,77,539,7
11201,2023-12,514,144,304,66,508,6
11201,2024-01,545,172,295,78,536,9
11201,2024-02,635,191,367,77,626,9
11201,2024-03,673,169,420,84,666,7
11201,2024-04,660,209,367,84,648,12
11201,2024-05,674,197,374,103,669,5
11201,2024-06,611,222,314,75,603,8
11201,2024-07,627,202,342,83,620,7
11201,2024-08,681,223,388,70,673,8
11201,2024-09,596,197,310,89,588,8
11201,2024-10,662,182,391,89,653,9
11201,2024-11,609,203,332,74,601,8
11201,2024-12,508,156,269,83,500,8
11203,2020-01,350,103,167,80,345,5
11203,2020-02,282,86,138,58,278,4
11203,2020-03,295,91,145,59,289,6
11203,2020-04,275,107,122,46,271,4
11203,2020-05,265,89,123,53,262,3
11203,2020-06,264,92,114,58,261,3
11203,2020-07,314,126,120,68,311,3
11203,2020-08,364,140,151,73,361,3
11203,2020-09,347,137,146,64,342,5
11203,2020-10,351,123,143,85,349,2
11203,2020-11,351,118,156,77,347,4
11203,2020-12,329,124,145,60,326,3
11203,2021-01,345,138,150,57,342,3
11203,2021-02,306,92,151,63,306,0
11203,2021-03,319,109,140,70,317,2
11203,2021-04,319,104,141,74,316,3
11203,2021-05,318,120,131,67,315,3
11203,2021-06,344,112,168,64,342,2
11203,2021-07,378,128,158,92,373,5
11203,2021-08,321,115,128,78,315,6
11203,2021-09,316,123,133,60,312,4
11203,2021-10,397,141,175,81,394,3
11203,2021-11,366,145,138,83,363,3
11203,2021-12,347,127,153,67,342,5
11203,2022-01,338,140,123,75,332,6
11203,2022-02,307,106,125,76,305,2
11203,2022-03,366,132,147,87,360,6
11203,2022-04,382,121,152,109,382,0
11203,2022-05,366,137,143,86,362,4
11203,2022-06,451,164,168,119,441,10
11203,2022-07,426,147,189,90,424,2
11203,2022-08,413,151,188,74,408,5
11203,2022-09,365,111,157,97,363,2
11203,2022-10,424,153,174,97,419,5
11203,2022-11,362,114,170,78,357,5
11203,2022-12,337,103,151,83,332,5
11203,2023-01,433,143,183,107,428,5
11203,2023-02,401,145,178,78,400,1
11203,2023-03,431,143,199,89,426,5
11203,2023-04,375,136,141,98,369,6
11203,2023-05,420,136,188,96,416,4
11203,2023-06,414,133,186,95,411,3
11203,2023-07,419,135,184,100,413,6
11203,2023-08,413,148,172,93,409,4
11203,2023-09,380,116,184,80,375,5
11203,2023-10,419,139,184,96,416,3
11203,2023-11,401,120,196,85,395,6
11203,2023-12,398,124,178,96,398,0
11203,2024-01,407,136,180,91,401,6
11203,2024-02,379,114,192,73,375,4
11203,2024-03,445,143,215,87,441,4
11203,2024-04,413,122,188,103,392,21
11203,2024-05,487,147,231,109,482,5
11203,2024-06,453,135,217,101,448,5
11203,2024-07,462,132,244,86,457,5
11203,2024-08,477,170,222,85,476,1
11203,2024-09,443,149,203,91,439,4
11203,2024-10,470,148,198,124,464,6
11203,2024-11,430,116,194,120,423,7
11203,2024-12,423,148,176,99,419,4
11204,2020-01,158,34,93,31,156,2
11204,2020-02,132,28,80,24,127,5
11204,2020-03,141,28,86,27,139,2
11204,2020-04,96,18,66,12,96,0
11204,2020-05,123,31,77,15,122,1
11204,2020-06,121,39,67,15,120,1
11204,2020-07,177,50,93,34,174,3
11204,2020-08,183,45,106,32,182,1
11204,2020-09,165,34,95,36,165,0
11204,2020-10,160,39,91,30,159,1
11204,2020-11,142,41,74,27,140,2
11204,2020-12,136,37,82,17,136,0
11204,2021-01,144,40,73,31,143,1
11204,2021-02,138,38,71,29,137,1
11204,2021-03,170,54,93,23,169,1
11204,2021-04,171,59,72,40,169,2
11204,2021-05,161,58,80,23,161,0
11204,2021-06,142,47,74,21,139,3
11204,2021-07,157,48,70,39,153,4
11204,2021-08,192,55,98,39,188,4
11204,2021-09,173,46,88,39,173,0
11204,2021-10,176,49,89,38,174,2
11204,2021-11,195,56,101,38,192,3
11204,2021-12,178,56,86,36,176,2
11204,2022-01,183,50,105,28,181,2
11204,2022-02,172,52,95,25,170,2
11204,2022-03,189,51,107,31,186,3
11204,2022-04,198,47,110,41,196,2
11204,2022-05,189,71,84,34,189,0
11204,2022-06,172,45,98,29,169,3
11204,2022-07,199,58,110,31,196,3
11204,2022-08,214,72,104,38,213,1
11204,2022-09,187,62,90,35,186,1
11204,2022-10,183,54,100,29,179,4
11204,2022-11,202,65,99,38,202,0
11204,2022-12,164,53,85,26,160,4
11204,2023-01,140,41,80,19,139,1
11204,2023-02,185,66,99,20,182,3
11204,2023-03,199,55,120,24,196,3
11204,2023-04,219,58,141,20,217,2
11204,2023-05,231,67,126,38,230,1
11204,2023-06,185,50,101,34,184,1
11204,2023-07,183,61,95,27,181,2
11204,2023-08,195,43,119,33,195,0
11204,2023-09,173,47,87,39,171,2
11204,2023-10,211,74,101,36,209,2
11204,2023-11,203,56,106,41,203,0
11204,2023-12,205,53,121,31,204,1
11204,2024-01,199,38,124,37,198,1
11204,2024-02,169,51,99,19,165,4
11204,2024-03,186,71,92,23,185,1
11204,2024-04,177,61,89,27,177,0
11204,2024-05,235,69,124,42,234,1
11204,2024-06,201,58,103,40,199,2
11204,2024-07,196,59,101,36,195,1
11204,2024-08,196,67,98,31,195,1
11204,2024-09,168,52,96,20,167,1
11204,2024-10,187,61,94,32,185,2
11204,2024-11,144,43,76,25,140,4
11204,2024-12,160,40,99,21,160,0
11205,2020-01,283,90,150,43,279,4
11205,2020-02,212,82,96,34,205,7
11205,2020-03,159,53,73,33,155,4
11205,2020-04,157,42,89,26,157,0
11205,2020-05,223,87,114,22,222,1
11205,2020-06,187,53,110,24,187,0
11205,2020-07,181,64,82,35,177,4
11205,2020-08,257,98,129,30,254,3
11205,2020-09,234,84,116,34,229,5
11205,2020-10,223,67,117,39,221,2
11205,2020-11,216,73,110,33,214,2
11205,2020-12,205,70,101,34,200,5
11205,2021-01,180,56,93,31,179,1
11205,2021-02,156,48,63,45,153,3
11205,2021-03,199,56,97,46,198,1
11205,2021-04,166,52,85,29,163,1
11205,2021-05,191,52,98,41,190,1
11205,2021-06,208,58,102,48,203,5
11205,2021-07,228,71,120,37,219,9
11205,2021-08,182,55,90,37,175,7
11205,2021-09,189,64,96,29,184,5
11205,2021-10,211,61,117,33,209,2
11205,2021-11,201,69,108,24,198,3
11205,2021-12,204,67,98,39,202,2
11205,2022-01,205,60,100,45,203,2
11205,2022-02,182,61,77,44,179,3
11205,2022-03,209,58,100,51,205,4
11205,2022-04,221,64,118,39,217,4
11205,2022-05,257,79,130,48,256,1
11205,2022-06,217,56,113,48,215,2
11205,2022-07,214,70,112,32,213,1
11205,2022-08,248,98,117,33,245,3
11205,2022-09,207,66,112,29,206,1
11205,2022-10,233,71,118,44,228,5
11205,2022-11,200,52,104,44,196,4
11205,2022-12,216,64,101,51,211,5
11205,2023-01,218,62,124,32,216,2
11205,2023-02,203,59,99,45,201,2
11205,2023-03,204,64,119,21,204,0
11205,2023-04,194,61,91,42,192,2
11205,2023-05,221,64,120,37,221,0
11205,2023-06,186,54,91,41,179,7
11205,2023-07,232,64,128,40,230,2
11205,2023-08,216,60,120,36,214,2
11205,2023-09,255,75,128,52,252,3
11205,2023-10,229,73,112,44,225,4
11205,2023-11,252,82,131,39,246,6
11205,2023-12,206,67,97,42,200,6
11205,2024-01,220,72,103,45,215,5
11205,2024-02,220,65,113,42,219,1
11205,2024-03,227,78,101,48,225,2
11205,2024-04,208,53,107,48,207,1
11205,2024-05,249,64,134,51,246,3
11205,2024-06,271,86,143,42,267,4
11205,2024-07,265,99,109,57,261,4
11205,2024-08,272,89,130,53,266,6
11205,2024-09,238,80,115,43,235,3
11205,2024-10,287,75,162,50,283,4
11205,2024-11,213,62,118,33,211,2
11205,2024-12,212,56,121,35,210,2
11206,2020-01,587,175,303,109,579,8
11206,2020-02,522,138,310,74,516,6
11206,2020-03,452,140,238,74,446,6
11206,2020-04,311,120,136,55,302,9
11206,2020-05,451,152,217,82,442,9
11206,2020-06,503,145,256,102,496,7
11206,2020-07,530,164,284,82,523,7
11206,2020-08,613,184,315,114,605,8
11206,2020-09,498,178,247,73,490,8
11206,2020-10,551,178,290,83,545,6
11206,2020-11,454,146,233,75,447,7
11206,2020-12,438,141,225,72,431,7
11206,2021-01,440,133,224,83,430,10
11206,2021-02,372,135,169,68,364,7
11206,2021-03,468,137,248,83,458,9
11206,2021-04,444,150,226,68,435,7
11206,2021-05,484,161,250,73,473,11
11206,2021-06,534,191,271,72,529,5
11206,2021-07,547,168,271,108,531,16
11206,2021-08,532,191,250,91,526,6
11206,2021-09,524,175,262,87,510,14
11206,2021-10,580,209,277,94,567,13
11206,2021-11,515,171,246,98,505,10
11206,2021-12,506,199,226,81,498,8
11206,2022-01,483,141,255,87,478,5
11206,2022-02,460,136,244,80,451,9
11206,2022-03,497,138,252,107,490,7
11206,2022-04,522,166,255,101,516,6
11206,2022-05,639,209,303,127,634,5
11206,2022-06,614,209,302,103,610,4
11206,2022-07,555,191,258,106,549,6
11206,2022-08,595,185,309,101,586,9
11206,2022-09,525,171,269,85,517,8
11206,2022-10,529,171,268,90,521,8
11206,2022-11,517,156,255,106,514,3
11206,2022-12,536,163,275,98,527,9
11206,2023-01,562,185,300,77,554,8
11206,2023-02,490,168,247,75,483,7
11206,2023-03,616,182,316,118,606,10
11206,2023-04,586,188,303,95,576,10
11206,2023-05,598,180,307,111,592,6
11206,2023-06,604,193,299,112,594,10
11206,2023-07,650,232,338,80,640,10
11206,2023-08,583,191,283,109,576,7
11206,2023-09,574,201,272,101,566,8
11206,2023-10,611,230,259,122,607,4
11206,2023-11,554,207,230,117,545,9
11206,2023-12,502,174,230,98,491,11
11206,2024-01,577,185,271,121,573,4
11206,2024-02,506,158,257,91,495,11
11206,2024-03,571,174,291,106,560,11
11206,2024-04,586,172,312,102,572,14
11206,2024-05,696,225,365,106,684,12
11206,2024-06,578,182,298,98,575,3
11206,2024-07,598,193,315,90,587,11
11206,2024-08,644,197,329,118,632,12
11206,2024-09,646,201,344,101,642,4
11206,2024-10,620,186,326,108,606,14
11206,2024-11,591,189,296,106,584,7
11206,2024-12,452,113,252,87,449,3
11207,2020-01,650,255,280,115,637,13
11207,2020-02,623,241,307,75,606,17
11207,2020-03,602,230,274,98,590,12
11207,2020-04,485,169,232,84,476,9
11207,2020-05,540,221,241,78,524,16
11207,2020-06,563,202,267,94,551,12
11207,2020-07,629,262,258,109,615,14
11207,2020-08,626,269,249,108,616,10
11207,2020-09,608,254,249,105,599,9
11207,2020-10,604,258,247,99,589,15
11207,2020-11,588,238,240,110,581,7
11207,2020-12,513,199,223,91,506,7
11207,2021-01,557,215,261,81,548,9
11207,2021-02,472,186,217,69,462,10
11207,2021-03,558,212,266,80,541,17
11207,2021-04,502,200,193,109,490,11
11207,2021-05,616,244,258,114,595,21
11207,2021-06,677,262,282,133,668,9
11207,2021-07,653,256,272,125,647,6
11207,2021-08,672,266,286,120,662,10
11207,2021-09,694,294,271,129,681,13
11207,2021-10,699,281,302,116,688,11
11207,2021-11,731,275,310,146,712,19
11207,2021-12,737,251,348,138,724,13
11207,2022-01,627,263,259,105,610,17
11207,2022-02,653,244,297,112,645,8
11207,2022-03,781,256,394,131,770,11
11207,2022-04,691,231,349,111,674,17
11207,2022-05,848,296,409,143,833,15
11207,2022-06,745,209,371,165,737,8
11207,2022-07,852,275,430,147,840,12
11207,2022-08,762,266,368,128,751,11
11207,2022-09,808,289,381,138,799,9
11207,2022-10,782,267,356,159,771,11
11207,2022-11,755,267,339,149,739,16
11207,2022-12,713,220,365,128,704,9
11207,2023-01,748,275,347,126,733,15
11207,2023-02,679,226,319,134,671,8
11207,2023-03,866,292,417,157,851,15
11207,2023-04,750,273,336,141,734,16
11207,2023-05,873,314,394,165,858,15
11207,2023-06,858,288,396,174,846,12
11207,2023-07,834,272,413,149,817,17
11207,2023-08,754,258,337,159,744,10
11207,2023-09,702,247,318,137,689,13
11207,2023-10,798,277,373,148,782,16
11207,2023-11,786,282,355,149,769,17
11207,2023-12,772,278,333,161,760,12
11207,2024-01,838,274,403,161,821,17
11207,2024-02,739,261,354,124,726,13
11207,2024-03,773,282,368,123,753,20
11207,2024-04,821,286,385,150,810,11
11207,2024-05,864,297,404,163,849,15
11207,2024-06,921,327,428,166,911,10
11207,2024-07,866,300,409,157,854,12
11207,2024-08,845,269,418,158,838,7
11207,2024-09,801,262,395,144,792,9
11207,2024-10,885,274,453,158,874,11
11207,2024-11,846,261,433,152,834,12
11207,2024-12,707,202,394,111,698,9
11208,2020-01,637,223,298,116,628,9
11208,2020-02,591,241,278,72,574,17
11208,2020-03,511,191,238,82,489,22
11208,2020-04,379,144,172,63,367,12
11208,2020-05,479,212,203,64,465,14
11208,2020-06,492,178,221,93,479,13
11208,2020-07,532,186,253,93,519,13
11208,2020-08,582,221,254,107,577,5
11208,2020-09,597,229,278,90,585,12
11208,2020-10,564,224,262,78,552,12
11208,2020-11,527,198,252,77,510,17
11208,2020-12,472,194,218,60,462,10
11208,2021-01,523,197,257,69,512,11
11208,2021-02,435,168,210,57,429,6
11208,2021-03,530,194,261,75,515,7
11208,2021-04,500,166,245,89,482,7
11208,2021-05,546,200,260,86,533,13
11208,2021-06,579,195,289,95,568,11
11208,2021-07,658,250,322,86,646,12
11208,2021-08,617,221,289,107,606,11
11208,2021-09,584,226,269,89,575,9
11208,2021-10,677,236,336,105,669,8
11208,2021-11,693,241,336,116,688,5
11208,2021-12,644,205,323,116,631,13
11208,2022-01,659,233,331,95,646,13
11208,2022-02,615,230,298,87,600,15
11208,2022-03,744,245,389,110,727,17
11208,2022-04,704,225,387,92,695,9
11208,2022-05,808,269,443,96,791,17
11208,2022-06,712,257,329,126,702,10
11208,2022-07,702,249,326,127,693,9
11208,2022-08,685,234,354,97,672,13
11208,2022-09,583,204,281,98,577,6
11208,2022-10,734,265,341,128,721,13
11208,2022-11,644,209,305,130,632,12
11208,2022-12,632,225,316,91,622,10
11208,2023-01,674,238,327,109,658,16
11208,2023-02,615,217,277,121,602,13
11208,2023-03,693,238,332,123,682,11
11208,2023-04,771,258,359,154,755,16
11208,2023-05,789,280,369,140,778,11
11208,2023-06,718,245,360,113,710,8
11208,2023-07,866,333,385,148,851,15
11208,2023-08,724,262,353,109,716,8
11208,2023-09,736,263,356,117,725,11
11208,2023-10,714,243,333,138,702,12
11208,2023-11,723,286,338,99,707,16
11208,2023-12,695,227,328,140,684,11
11208,2024-01,697,258,328,111,683,14
11208,2024-02,675,232,325,118,663,12
11208,2024-03,697,237,329,131,686,11
11208,2024-04,724,242,367,115,707,17
11208,2024-05,799,286,387,126,789,10
11208,2024-06,750,263,371,116,743,7
11208,2024-07,784,268,375,141,776,8
11208,2024-08,762,231,389,142,758,4
11208,2024-09,755,263,377,115,752,3
11208,2024-10,770,245,413,112,754,16
11208,2024-11,678,223,337,118,673,5
11208,2024-12,610,151,362,97,600,10
11209,2020-01,184,39,112,33,183,1
11209,2020-02,188,52,97,39,188,0
11209,2020-03,197,64,93,40,193,4
11209,2020-04,134,44,69,21,131,3
11209,2020-05,190,55,104,31,189,1
11209,2020-06,174,57,89,28,173,1
11209,2020-07,192,62,87,43,186,6
11209,2020-08,241,67,133,41,239,2
11209,2020-09,202,48,124,30,201,1
11209,2020-10,233,51,129,53,230,3
11209,2020-11,216,60,126,30,215,1
11209,2020-12,195,56,115,24,194,1
11209,2021-01,161,44,94,23,159,2
11209,2021-02,147,38,78,31,145,2
11209,2021-03,169,54,89,26,165,4
11209,2021-04,177,60,87,30,177,0
11209,2021-05,206,52,113,41,205,1
11209,2021-06,221,49,132,40,216,5
11209,2021-07,212,55,129,28,212,0
11209,2021-08,188,40,127,21,187,1
11209,2021-09,214,48,123,43,212,2
11209,2021-10,261,62,164,35,259,2
11209,2021-11,239,56,145,38,233,6
11209,2021-12,252,65,154,33,248,4
11209,2022-01,240,42,166,32,236,4
11209,2022-02,279,47,199,33,276,3
11209,2022-03,293,71,186,36,292,1
11209,2022-04,230,64,138,28,230,0
11209,2022-05,226,60,138,28,220,6
11209,2022-06,245,47,169,29,244,1
11209,2022-07,252,66,151,35,249,3
11209,2022-08,248,67,144,37,245,3
11209,2022-09,270,64,166,40,267,3
11209,2022-10,236,43,163,30,234,2
11209,2022-11,247,44,166,37,246,1
11209,2022-12,247,51,171,25,246,1
11209,2023-01,274,71,168,35,270,4
11209,2023-02,242,70,146,26,241,1
11209,2023-03,270,63,178,29,269,1
11209,2023-04,245,56,151,38,244,1
11209,2023-05,251,60,146,45,248,3
11209,2023-06,268,75,152,41,268,0
11209,2023-07,258,62,141,55,258,0
11209,2023-08,230,53,144,33,229,1
11209,2023-09,229,63,138,28,228,1
11209,2023-10,272,70,168,34,270,2
11209,2023-11,246,60,149,37,245,1
11209,2023-12,292,81,182,29,288,4
11209,2024-01,271,72,167,32,270,1
11209,2024-02,225,72,131,22,220,5
11209,2024-03,264,71,146,47,259,5
11209,2024-04,212,48,134,30,211,1
11209,2024-05,271,76,171,24,268,3
11209,2024-06,239,71,129,39,237,2
11209,2024-07,249,55,153,41,244,5
11209,2024-08,242,42,164,36,241,1
11209,2024-09,219,52,129,38,216,3
11209,2024-10,229,60,134,35,228,1
11209,2024-11,234,51,148,35,234,0
11209,2024-12,207,56,125,26,205,2
11210,2020-01,221,69,122,30,221,0
11210,2020-02,200,69,101,30,193,7
11210,2020-03,208,75,98,35,202,6
11210,2020-04,152,61,70,21,151,1
11210,2020-05,207,70,109,28,202,5
11210,2020-06,183,67,88,28,178,5
11210,2020-07,215,74,115,26,214,1
11210,2020-08,251,95,120,36,245,6
11210,2020-09,179,72,75,32,177,2
11210,2020-10,191,65,96,30,190,1
11210,2020-11,217,72,117,28,216,1
11210,2020-12,195,77,83,35,187,8
11210,2021-01,195,62,104,29,189,6
11210,2021-02,163,50,81,32,161,2
11210,2021-03,207,71,104,32,200,7
11210,2021-04,203,62,107,34,196,2
11210,2021-05,227,73,110,44,224,3
11210,2021-06,215,70,97,48,213,2
11210,2021-07,212,91,83,38,207,5
11210,2021-08,226,85,99,42,224,2
11210,2021-09,247,99,105,43,244,3
11210,2021-10,272,106,121,45,265,7
11210,2021-11,229,97,98,34,223,6
11210,2021-12,260,94,128,38,257,3
11210,2022-01,213,70,98,45,211,2
11210,2022-02,231,84,115,32,229,2
11210,2022-03,222,73,116,33,219,3
11210,2022-04,218,92,88,38,218,0
11210,2022-05,239,80,110,49,235,4
11210,2022-06,257,79,136,42,254,3
11210,2022-07,277,92,137,48,273,4
11210,2022-08,269,79,143,47,265,4
11210,2022-09,290,102,133,55,288,2
11210,2022-10,262,87,117,58,257,5
11210,2022-11,309,88,179,42,304,5
11210,2022-12,281,96,145,40,279,2
11210,2023-01,245,83,117,45,243,2
11210,2023-02,272,85,139,48,268,4
11210,2023-03,274,93,125,56,271,3
11210,2023-04,283,105,127,51,279,4
11210,2023-05,287,76,159,52,283,4
11210,2023-06,322,98,168,56,322,0
11210,2023-07,300,72,173,55,295,5
11210,2023-08,272,85,137,50,265,7
11210,2023-09,297,104,152,41,295,2
11210,2023-10,319,96,168,55,313,6
11210,2023-11,276,87,148,41,269,7
11210,2023-12,247,76,146,25,246,1
11210,2024-01,286,80,154,52,283,3
11210,2024-02,267,61,157,49,263,4
11210,2024-03,319,99,170,50,318,1
11210,2024-04,261,73,143,45,260,1
11210,2024-05,304,91,158,55,300,4
11210,2024-06,340,88,198,54,337,3
11210,2024-07,321,92,164,65,320,1
11210,2024-08,355,96,190,69,351,4
11210,2024-09,289,85,148,56,287,2
11210,2024-10,307,91,155,61,304,3
11210,2024-11,284,82,163,39,282,2
11210,2024-12,269,81,139,49,266,3
11211,2020-01,318,120,150,48,312,6
11211,2020-02,325,115,161,49,320,5
11211,2020-03,289,105,136,48,284,5
11211,2020-04,214,83,103,28,206,8
11211,2020-05,328,128,156,44,321,7
11211,2020-06,357,133,186,38,345,12
11211,2020-07,382,154,183,45,376,6
11211,2020-08,399,163,183,53,393,6
11211,2020-09,381,156,180,45,376,5
11211,2020-10,405,158,185,62,400,5
11211,2020-11,389,162,174,53,387,2
11211,2020-12,294,126,134,34,292,2
11211,2021-01,318,115,156,47,313,5
11211,2021-02,244,82,121,41,243,1
11211,2021-03,325,112,169,44,319,5
11211,2021-04,346,124,161,61,341,4
11211,2021-05,376,127,190,59,371,5
11211,2021-06,375,139,173,63,361,14
11211,2021-07,399,127,198,74,391,8
11211,2021-08,408,143,199,66,402,6
11211,2021-09,451,167,218,66,443,8
11211,2021-10,430,167,196,67,425,5
11211,2021-11,431,150,219,62,424,7
11211,2021-12,434,148,229,57,432,2
11211,2022-01,426,158,212,56,418,8
11211,2022-02,344,141,168,35,332,12
11211,2022-03,415,156,203,56,409,6
11211,2022-04,420,174,188,58,415,5
11211,2022-05,508,177,263,68,506,2
11211,2022-06,494,182,256,56,484,10
11211,2022-07,514,208,240,66,507,7
11211,2022-08,540,229,246,65,531,9
11211,2022-09,483,203,213,67,472,11
11211,2022-10,472,182,240,50,468,4
11211,2022-11,501,192,244,65,491,10
11211,2022-12,424,159,213,52,412,12
11211,2023-01,419,163,202,54,418,1
11211,2023-02,331,135,165,31,325,6
11211,2023-03,431,155,205,71,429,2
11211,2023-04,408,149,212,47,401,7
11211,2023-05,466,170,247,49,462,4
11211,2023-06,477,180,230,67,468,9
11211,2023-07,429,182,190,57,424,5
11211,2023-08,474,192,224,58,470,4
11211,2023-09,435,190,181,64,426,9
11211,2023-10,442,188,192,62,433,9
11211,2023-11,410,185,168,57,402,8
11211,2023-12,438,164,217,57,426,12
11211,2024-01,472,193,210,69,466,6
11211,2024-02,441,158,211,72,437,4
11211,2024-03,432,174,201,57,427,5
11211,2024-04,396,147,192,57,390,6
11211,2024-05,484,170,245,69,472,12
11211,2024-06,430,165,212,53,422,8
11211,2024-07,418,161,204,53,412,6
11211,2024-08,440,155,225,60,434,6
11211,2024-09,471,182,218,71,463,8
11211,2024-10,403,152,203,48,397,6
11211,2024-11,384,129,206,49,378,6
11211,2024-12,339,104,195,40,336,3
11212,2020-01,529,170,260,99,527,2
11212,2020-02,520,177,229,114,518,2
11212,2020-03,549,208,227,114,545,4
11212,2020-04,484,169,238,77,480,4
11212,2020-05,571,203,284,84,561,10
11212,2020-06,527,180,241,106,517,10
11212,2020-07,562,220,233,109,561,1
11212,2020-08,609,224,271,114,606,3
11212,2020-09,483,193,207,83,475,8
11212,2020-10,610,243,245,122,600,10
11212,2020-11,581,224,261,96,566,15
11212,2020-12,565,212,258,95,561,4
11212,2021-01,560,181,256,123,554,6
11212,2021-02,483,162,206,115,480,3
11212,2021-03,605,196,291,118,594,9
11212,2021-04,574,197,261,116,568,5
11212,2021-05,620,236,264,120,612,8
11212,2021-06,644,216,264,164,634,10
11212,2021-07,572,209,241,122,563,9
11212,2021-08,610,237,227,146,603,7
11212,2021-09,649,227,265,157,634,15
11212,2021-10,668,232,291,145,656,12
11212,2021-11,632,250,256,126,622,10
11212,2021-12,655,273,258,124,649,6
11212,2022-01,572,207,234,131,569,3
11212,2022-02,563,199,248,116,552,11
11212,2022-03,625,232,275,118,614,11
11212,2022-04,670,222,309,139,652,18
11212,2022-05,702,251,319,132,692,10
11212,2022-06,729,238,330,161,719,10
11212,2022-07,774,261,349,164,759,15
11212,2022-08,697,244,300,153,686,11
11212,2022-09,657,199,293,165,649,8
11212,2022-10,734,257,328,149,717,17
11212,2022-11,661,228,311,122,652,9
11212,2022-12,650,210,301,139,640,10
11212,2023-01,781,245,378,158,773,8
11212,2023-02,678,200,321,157,673,5
11212,2023-03,718,232,337,149,711,7
11212,2023-04,683,222,311,150,675,8
11212,2023-05,772,270,356,146,765,7
11212,2023-06,752,244,363,145,738,14
11212,2023-07,808,279,360,169,792,16
11212,2023-08,784,237,396,151,769,15
11212,2023-09,621,199,280,142,616,5
11212,2023-10,755,239,346,170,743,12
11212,2023-11,641,220,291,130,634,7
11212,2023-12,715,216,359,140,707,8
11212,2024-01,745,248,352,145,736,9
11212,2024-02,756,239,367,150,742,14
11212,2024-03,780,240,363,177,768,12
11212,2024-04,667,219,293,155,658,9
11212,2024-05,801,254,381,166,793,8
11212,2024-06,889,277,461,151,873,16
11212,2024-07,787,231,383,173,780,7
11212,2024-08,831,253,414,164,825,6
11212,2024-09,825,231,420,174,813,12
11212,2024-10,827,233,446,148,819,8
11212,2024-11,767,220,404,143,758,9
11212,2024-12,736,222,376,138,732,4
11213,2020-01,376,126,191,59,374,2
11213,2020-02,355,95,190,70,353,2
11213,2020-03,360,114,186,60,354,6
11213,2020-04,238,66,126,46,234,4
11213,2020-05,307,98,155,54,305,2
11213,2020-06,286,101,133,52,282,4
11213,2020-07,355,126,174,55,353,2
11213,2020-08,379,130,191,58,377,2
11213,2020-09,356,120,174,62,350,6
11213,2020-10,388,135,182,71,380,8
11213,2020-11,407,141,213,53,399,8
11213,2020-12,355,128,177,50,350,5
11213,2021-01,328,111,162,55,325,3
11213,2021-02,277,83,143,51,275,2
11213,2021-03,350,114,179,57,345,5
11213,2021-04,285,99,141,45,280,5
11213,2021-05,352,125,166,61,348,4
11213,2021-06,382,128,172,82,377,5
11213,2021-07,437,146,213,78,432,5
11213,2021-08,348,121,150,77,344,4
11213,2021-09,372,118,184,70,371,1
11213,2021-10,410,142,182,86,402,8
11213,2021-11,365,112,171,82,363,2
11213,2021-12,365,99,177,89,360,5
11213,2022-01,411,144,191,76,407,4
11213,2022-02,314,102,146,66,311,3
11213,2022-03,419,136,189,94,416,3
11213,2022-04,406,132,194,80,401,5
11213,2022-05,466,152,224,90,458,8
11213,2022-06,410,128,190,92,407,3
11213,2022-07,437,130,213,94,430,7
11213,2022-08,413,159,177,77,406,7
11213,2022-09,416,126,189,101,413,3
11213,2022-10,443,133,209,101,435,8
11213,2022-11,409,135,182,92,404,5
11213,2022-12,388,130,170,88,384,4
11213,2023-01,456,169,202,85,448,8
11213,2023-02,376,107,192,77,370,6
11213,2023-03,410,130,196,84,406,4
11213,2023-04,415,150,189,76,410,5
11213,2023-05,479,164,227,88,472,7
11213,2023-06,452,177,188,87,443,9
11213,2023-07,401,153,181,67,396,5
11213,2023-08,448,157,208,83,445,3
11213,2023-09,424,145,206,73,420,4
11213,2023-10,470,148,234,88,464,6
11213,2023-11,419,140,196,83,407,12
11213,2023-12,390,120,188,82,381,9
11213,2024-01,434,135,199,100,424,10
11213,2024-02,378,112,197,69,375,3
11213,2024-03,367,121,178,68,363,4
11213,2024-04,371,112,189,70,363,8
11213,2024-05,400,122,199,79,396,4
11213,2024-06,407,120,196,91,402,5
11213,2024-07,421,141,206,74,414,7
11213,2024-08,436,127,235,74,430,6
11213,2024-09,402,139,187,76,399,3
11213,2024-10,446,125,239,82,437,9
11213,2024-11,401,127,213,61,394,7
11213,2024-12,341,90,180,71,340,1
11214,2020-01,241,79,127,35,234,7
11214,2020-02,240,80,125,35,236,4
11214,2020-03,205,64,110,31,201,4
11214,2020-04,154,42,83,29,153,1
11214,2020-05,236,52,141,43,233,3
11214,2020-06,227,53,135,39,225,2
11214,2020-07,216,57,127,32,212,4
11214,2020-08,232,72,127,33,227,5
11214,2020-09,248,64,144,40,246,2
11214,2020-10,228,71,116,41,226,2
11214,2020-11,237,62,137,38,230,7
11214,2020-12,233,73,129,31,229,4
11214,2021-01,229,74,114,41,226,3
11214,2021-02,211,66,104,41,209,2
11214,2021-03,261,76,137,48,258,3
11214,2021-04,222,70,111,41,217,5
11214,2021-05,236,66,127,43,235,1
11214,2021-06,288,78,146,64,286,2
11214,2021-07,232,66,127,39,231,1
11214,2021-08,258,72,137,49,252,6
11214,2021-09,250,67,131,52,246,4
11214,2021-10,279,84,146,49,275,4
11214,2021-11,303,78,179,46,302,1
11214,2021-12,293,104,150,39,290,3
11214,2022-01,250,71,131,48,246,4
11214,2022-02,216,71,103,42,213,3
11214,2022-03,252,74,122,56,251,1
11214,2022-04,295,84,155,56,290,5
11214,2022-05,290,85,160,45,285,5
11214,2022-06,344,106,182,56,342,2
11214,2022-07,325,98,177,50,323,2
11214,2022-08,348,115,182,51,343,5
11214,2022-09,313,94,175,44,311,2
11214,2022-10,321,78,188,55,321,0
11214,2022-11,321,68,181,72,316,5
11214,2022-12,300,95,152,53,298,2
11214,2023-01,314,101,164,49,311,3
11214,2023-02,270,79,152,39,268,2
11214,2023-03,341,115,172,54,337,4
11214,2023-04,334,96,195,43,330,4
11214,2023-05,372,102,202,68,371,1
11214,2023-06,345,105,181,59,343,2
11214,2023-07,355,113,199,43,349,6
11214,2023-08,343,115,178,50,340,3
11214,2023-09,339,111,173,55,336,3
11214,2023-10,370,92,226,52,369,1
11214,2023-11,333,87,176,70,331,2
11214,2023-12,307,94,172,41,306,1
11214,2024-01,353,100,222,31,347,6
11214,2024-02,317,88,195,34,314,3
11214,2024-03,348,81,216,51,345,3
11214,2024-04,340,102,189,49,336,4
11214,2024-05,429,123,236,70,427,2
11214,2024-06,440,115,269,56,438,2
11214,2024-07,385,92,242,51,384,1
11214,2024-08,404,105,242,57,399,5
11214,2024-09,356,91,214,51,350,6
11214,2024-10,361,97,214,50,357,4
11214,2024-11,349,97,220,32,347,2
11214,2024-12,274,67,170,37,271,3
11215,2020-01,187,59,102,26,185,2
11215,2020-02,152,53,74,25,152,0
11215,2020-03,183,50,95,38,181,2
11215,2020-04,149,54,71,24,147,2
11215,2020-05,150,40,87,23,149,1
11215,2020-06,133,50,64,19,133,0
11215,2020-07,188,71,87,30,186,2
11215,2020-08,188,61,108,19,186,2
11215,2020-09,197,60,113,24,196,1
11215,2020-10,175,53,106,16,171,4
11215,2020-11,174,54,88,32,171,3
11215,2020-12,170,55,88,27,166,4
11215,2021-01,166,53,98,15,164,2
11215,2021-02,129,47,69,13,126,3
11215,2021-03,155,58,77,20,153,1
11215,2021-04,159,61,77,21,157,1
11215,2021-05,174,54,95,25,171,3
11215,2021-06,186,58,110,18,186,0
11215,2021-07,208,62,111,35,203,5
11215,2021-08,146,36,88,22,144,2
11215,2021-09,214,63,108,43,214,0
11215,2021-10,217,82,91,44,215,2
11215,2021-11,182,57,93,32,177,5
11215,2021-12,242,89,114,39,236,6
11215,2022-01,152,47,83,22,150,2
11215,2022-02,184,62,90,32,183,1
11215,2022-03,184,59,97,28,183,1
11215,2022-04,183,48,101,34,181,2
11215,2022-05,187,60,100,27,185,2
11215,2022-06,220,81,104,35,218,2
11215,2022-07,228,85,112,31,226,2
11215,2022-08,253,98,120,35,249,4
11215,2022-09,236,82,111,43,235,1
11215,2022-10,213,82,96,35,210,3
11215,2022-11,188,72,93,23,182,6
11215,2022-12,186,69,94,23,184,2
11215,2023-01,198,68,93,37,195,3
11215,2023-02,159,59,82,18,156,3
11215,2023-03,210,79,94,37,208,2
11215,2023-04,178,55,91,32,175,3
11215,2023-05,218,74,120,24,216,2
11215,2023-06,217,95,93,29,212,5
11215,2023-07,182,55,87,40,179,3
11215,2023-08,234,84,115,35,232,2
11215,2023-09,176,64,85,27,173,3
11215,2023-10,177,66,87,24,175,2
11215,2023-11,187,66,90,31,179,8
11215,2023-12,178,69,86,23,175,3
11215,2024-01,205,91,94,20,200,5
11215,2024-02,178,72,78,28,176,2
11215,2024-03,177,56,88,33,173,4
11215,2024-04,193,70,101,22,191,2
11215,2024-05,198,61,102,35,195,3
11215,2024-06,235,82,122,31,233,2
11215,2024-07,183,68,89,26,181,2
11215,2024-08,203,58,107,38,201,2
11215,2024-09,183,58,90,35,183,0
11215,2024-10,160,55,74,31,158,2
11215,2024-11,157,54,76,27,154,3
11215,2024-12,128,32,75,21,126,2
11216,2020-01,351,127,183,41,345,6
11216,2020-02,305,97,145,63,304,1
11216,2020-03,313,97,168,48,307,6
11216,2020-04,291,114,129,48,283,8
11216,2020-05,367,131,178,58,358,9
11216,2020-06,313,99,154,60,312,1
11216,2020-07,355,126,174,55,351,4
11216,2020-08,315,119,140,56,310,5
11216,2020-09,301,99,156,46,296,5
11216,2020-10,291,113,136,42,286,5
11216,2020-11,313,122,145,46,311,2
11216,2020-12,285,113,125,47,280,5
11216,2021-01,291,119,103,69,289,2
11216,2021-02,222,79,106,37,221,1
11216,2021-03,271,112,116,43,263,8
11216,2021-04,250,85,116,49,247,2
11216,2021-05,265,99,109,57,261,4
11216,2021-06,291,100,124,67,286,5
11216,2021-07,315,100,155,60,295,20
11216,2021-08,316,113,134,69,312,4
11216,2021-09,310,110,131,69,308,2
11216,2021-10,314,114,141,59,311,3
11216,2021-11,272,99,120,53,268,4
11216,2021-12,264,104,119,41,258,6
11216,2022-01,247,88,124,35,245,2
11216,2022-02,268,107,123,38,265,3
11216,2022-03,309,107,150,52,302,7
11216,2022-04,305,97,152,56,302,3
11216,2022-05,349,114,174,61,345,4
11216,2022-06,360,129,173,58,357,3
11216,2022-07,379,137,179,63,374,5
11216,2022-08,324,115,143,66,320,4
11216,2022-09,327,116,153,58,322,5
11216,2022-10,322,120,139,63,316,6
11216,2022-11,342,115,167,60,337,5
11216,2022-12,310,120,136,54,298,12
11216,2023-01,334,106,171,57,331,3
11216,2023-02,298,112,148,38,290,8
11216,2023-03,317,112,152,53,310,7
11216,2023-04,322,124,141,57,316,6
11216,2023-05,347,122,165,60,336,11
11216,2023-06,355,123,178,54,351,4
11216,2023-07,374,128,180,66,369,5
11216,2023-08,357,126,179,52,349,8
11216,2023-09,360,136,152,72,353,7
11216,2023-10,392,126,217,49,383,9
11216,2023-11,320,96,174,50,314,6
11216,2023-12,343,100,177,66,338,5
11216,2024-01,355,109,198,48,346,9
11216,2024-02,337,119,164,54,331,6
11216,2024-03,329,109,174,46,324,5
11216,2024-04,333,94,171,68,328,5
11216,2024-05,374,115,180,79,370,4
11216,2024-06,374,115,192,67,367,7
11216,2024-07,380,136,171,73,374,6
11216,2024-08,375,125,183,67,373,2
11216,2024-09,354,113,183,58,351,3
11216,2024-10,430,160,202,68,424,6
11216,2024-11,390,148,176,66,387,3
11216,2024-12,285,85,156,44,280,5
11217,2020-01,285,95,152,38,280,5
11217,2020-02,266,85,147,34,262,4
11217,2020-03,204,63,106,35,197,7
11217,2020-04,128,42,69,17,127,1
11217,2020-05,233,76,129,28,227,6
11217,2020-06,186,57,96,33,184,2
11217,2020-07,234,76,131,27,227,7
11217,2020-08,252,71,136,45,249,3
11217,2020-09,255,73,150,32,246,9
11217,2020-10,236,82,114,40,232,4
11217,2020-11,218,78,112,28,213,5
11217,2020-12,200,49,121,30,200,0
11217,2021-01,218,72,114,32,215,3
11217,2021-02,186,36,102,48,183,3
11217,2021-03,222,51,129,42,217,3
11217,2021-04,190,63,83,44,189,1
11217,2021-05,232,80,112,40,226,6
11217,2021-06,255,79,134,42,249,6
11217,2021-07,249,68,131,50,245,4
11217,2021-08,240,60,135,45,235,5
11217,2021-09,246,88,117,41,244,2
11217,2021-10,296,82,152,62,292,4
11217,2021-11,297,97,152,48,286,11
11217,2021-12,265,79,148,38,261,4
11217,2022-01,235,82,116,37,228,7
11217,2022-02,255,75,140,40,251,4
11217,2022-03,301,76,171,54,300,1
11217,2022-04,272,75,149,48,268,4
11217,2022-05,312,120,150,42,310,2
11217,2022-06,371,123,197,51,364,7
11217,2022-07,350,103,195,52,346,4
11217,2022-08,334,102,174,58,330,4
11217,2022-09,361,119,188,54,358,3
11217,2022-10,361,121,183,57,357,4
11217,2022-11,353,96,196,61,350,3
11217,2022-12,319,102,174,43,314,5
11217,2023-01,372,127,197,48,366,6
11217,2023-02,305,100,157,48,302,3
11217,2023-03,325,98,175,52,319,6
11217,2023-04,302,102,160,40,298,4
11217,2023-05,344,111,184,49,342,2
11217,2023-06,344,120,163,61,338,6
11217,2023-07,393,126,210,57,389,4
11217,2023-08,349,115,187,47,342,7
11217,2023-09,302,97,149,56,298,4
11217,2023-10,358,132,177,49,356,2
11217,2023-11,279,86,147,46,278,1
11217,2023-12,327,101,176,50,324,3
11217,2024-01,289,85,163,41,286,3
11217,2024-02,248,71,128,49,241,7
11217,2024-03,300,101,145,54,296,4
11217,2024-04,324,104,181,39,320,4
11217,2024-05,353,97,188,68,351,2
11217,2024-06,317,89,184,44,314,3
11217,2024-07,310,75,188,47,308,2
11217,2024-08,299,91,168,40,294,5
11217,2024-09,340,112,168,60,335,5
11217,2024-10,311,101,155,55,310,1
11217,2024-11,342,115,175,52,340,2
11217,2024-12,288,86,156,46,288,0
11218,2020-01,120,48,45,27,114,6
11218,2020-02,109,54,45,10,107,2
11218,2020-03,141,40,76,25,140,1
11218,2020-04,100,39,44,17,99,1
11218,2020-05,126,41,70,15,126,0
11218,2020-06,147,38,87,22,144,3
11218,2020-07,149,47,79,23,148,1
11218,2020-08,122,41,55,26,120,2
11218,2020-09,139,50,70,19,137,2
11218,2020-10,135,43,65,27,134,1
11218,2020-11,166,62,81,23,165,1
11218,2020-12,175,54,80,41,170,5
11218,2021-01,137,46,69,22,133,4
11218,2021-02,97,31,42,24,94,3
11218,2021-03,157,43,86,28,155,2
11218,2021-04,133,34,74,25,129,4
11218,2021-05,138,54,59,25,136,2
11218,2021-06,154,47,79,28,153,1
11218,2021-07,183,54,115,14,182,1
11218,2021-08,181,60,93,28,177,4
11218,2021-09,145,54,70,21,142,3
11218,2021-10,172,53,95,24,167,5
11218,2021-11,190,62,107,21,188,2
11218,2021-12,166,58,74,34,159,7
11218,2022-01,143,50,74,19,140,3
11218,2022-02,152,65,63,24,147,5
11218,2022-03,184,61,100,23,181,3
11218,2022-04,107,29,53,25,107,0
11218,2022-05,164,54,83,27,161,3
11218,2022-06,177,53,98,26,175,2
11218,2022-07,163,63,71,29,157,6
11218,2022-08,169,58,87,24,169,0
11218,2022-09,183,50,99,34,183,0
11218,2022-10,175,63,82,30,175,0
11218,2022-11,140,44,79,17,137,3
11218,2022-12,164,56,76,32,158,6
11218,2023-01,171,60,70,41,169,2
11218,2023-02,139,42,69,28,136,3
11218,2023-03,145,44,78,23,144,1
11218,2023-04,151,39,82,30,149,2
11218,2023-05,165,58,76,31,162,3
11218,2023-06,169,56,87,26,168,1
11218,2023-07,145,50,71,24,144,1
11218,2023-08,152,57,69,26,151,1
11218,2023-09,154,56,70,28,152,2
11218,2023-10,140,41,70,29,140,0
11218,2023-11,129,52,50,27,128,1
11218,2023-12,157,56,64,37,157,0
11218,2024-01,154,60,67,27,152,2
11218,2024-02,181,74,79,28,178,3
11218,2024-03,170,62,80,28,170,0
11218,2024-04,137,51,59,27,134,3
11218,2024-05,139,44,64,31,137,2
11218,2024-06,157,55,59,43,157,0
11218,2024-07,164,49,79,36,163,1
11218,2024-08,183,62,90,31,182,1
11218,2024-09,169,68,73,28,165,4
11218,2024-10,168,57,81,30,164,4
11218,2024-11,154,39,80,35,152,2
11218,2024-12,114,27,63,24,114,0
11219,2020-01,171,56,97,18,169,2
11219,2020-02,179,72,86,21,177,2
11219,2020-03,144,38,86,20,140,4
11219,2020-04,131,47,60,24,130,1
11219,2020-05,141,49,68,24,136,5
11219,2020-06,161,49,84,28,160,1
11219,2020-07,184,72,84,28,183,1
11219,2020-08,179,60,89,30,179,0
11219,2020-09,200,60,108,32,198,2
11219,2020-10,181,57,101,23,180,1
11219,2020-11,138,40,75,23,137,1
11219,2020-12,195,75,110,10,193,2
11219,2021-01,155,47,88,20,154,1
11219,2021-02,140,46,67,27,140,0
11219,2021-03,155,42,89,24,152,3
11219,2021-04,148,45,77,26,145,2
11219,2021-05,147,52,74,21,146,1
11219,2021-06,152,53,74,25,150,2
11219,2021-07,168,63,85,20,165,3
11219,2021-08,164,56,88,20,162,2
11219,2021-09,179,60,83,36,176,3
11219,2021-10,182,66,95,21,181,1
11219,2021-11,188,62,92,34,187,1
11219,2021-12,211,88,104,19,209,2
11219,2022-01,179,67,91,21,176,3
11219,2022-02,177,59,92,26,176,1
11219,2022-03,175,59,96,20,174,1
11219,2022-04,203,72,111,20,200,3
11219,2022-05,190,66,91,33,184,6
11219,2022-06,268,105,128,35,264,4
11219,2022-07,274,81,157,36,270,4
11219,2022-08,227,82,123,22,224,3
11219,2022-09,271,91,136,44,269,2
11219,2022-10,209,74,107,28,205,4
11219,2022-11,216,73,115,28,214,2
11219,2022-12,196,74,89,33,193,3
11219,2023-01,266,87,158,21,261,5
11219,2023-02,162,56,91,15,160,2
11219,2023-03,180,60,91,29,178,2
11219,2023-04,199,71,108,20,199,0
11219,2023-05,193,69,105,19,192,1
11219,2023-06,234,73,130,31,233,1
11219,2023-07,202,52,121,29,201,1
11219,2023-08,208,73,108,27,206,2
11219,2023-09,208,59,112,37,207,1
11219,2023-10,224,65,129,30,221,3
11219,2023-11,209,60,123,26,204,5
11219,2023-12,224,81,113,30,223,1
11219,2024-01,229,83,113,33,223,6
11219,2024-02,213,66,116,31,208,5
11219,2024-03,202,55,114,33,200,2
11219,2024-04,209,61,121,27,207,2
11219,2024-05,218,53,126,39,216,2
11219,2024-06,232,59,139,34,231,1
11219,2024-07,196,60,105,31,194,2
11219,2024-08,214,57,128,29,211,3
11219,2024-09,206,54,127,25,202,4
11219,2024-10,200,53,113,34,197,3
11219,2024-11,220,67,132,21,219,1
11219,2024-12,175,50,108,17,173,2
11220,2020-01,323,114,169,40,310,13
11220,2020-02,292,105,149,38,284,8
11220,2020-03,302,102,170,30,298,4
11220,2020-04,246,69,141,36,242,4
11220,2020-05,304,98,157,49,297,7
11220,2020-06,281,102,138,41,277,4
11220,2020-07,328,107,173,48,321,7
11220,2020-08,368,119,189,60,362,6
11220,2020-09,382,136,201,45,370,12
11220,2020-10,354,130,178,46,342,12
11220,2020-11,327,115,167,45,325,2
11220,2020-12,276,106,134,36,274,2
11220,2021-01,289,101,141,47,284,5
11220,2021-02,233,85,111,37,232,1
11220,2021-03,284,95,152,37,283,1
11220,2021-04,297,94,148,55,295,2
11220,2021-05,299,111,153,35,292,7
11220,2021-06,351,126,179,46,347,4
11220,2021-07,361,125,192,44,357,4
11220,2021-08,353,145,169,39,348,5
11220,2021-09,346,144,154,48,342,4
11220,2021-10,343,134,146,63,337,6
11220,2021-11,337,135,178,24,330,7
11220,2021-12,375,184,146,45,372,3
11220,2022-01,389,197,162,30,384,5
11220,2022-02,330,132,160,38,323,7
11220,2022-03,395,147,208,40,390,5
11220,2022-04,352,129,178,45,347,5
11220,2022-05,395,153,207,35,393,2
11220,2022-06,410,150,213,47,409,1
11220,2022-07,432,187,210,35,426,6
11220,2022-08,395,153,201,41,390,5
11220,2022-09,383,160,174,49,377,6
11220,2022-10,426,162,217,47,417,9
11220,2022-11,350,139,168,43,347,3
11220,2022-12,330,103,198,29,321,9
11220,2023-01,381,149,188,44,372,9
11220,2023-02,320,132,162,26,314,6
11220,2023-03,356,138,182,36,352,4
11220,2023-04,379,130,212,37,374,5
11220,2023-05,400,143,206,51,396,4
11220,2023-06,403,148,198,57,398,5
11220,2023-07,451,143,254,54,447,4
11220,2023-08,424,150,229,45,422,2
11220,2023-09,462,157,255,50,460,2
11220,2023-10,446,148,232,66,441,5
11220,2023-11,394,122,224,48,392,2
11220,2023-12,396,123,225,48,394,2
11220,2024-01,422,136,236,50,418,4
11220,2024-02,387,147,196,44,377,10
11220,2024-03,433,131,240,62,429,4
11220,2024-04,451,164,237,50,446,5
11220,2024-05,417,145,224,48,413,4
11220,2024-06,449,166,233,50,443,6
11220,2024-07,361,126,194,41,357,4
11220,2024-08,424,154,228,42,419,5
11220,2024-09,411,141,216,54,407,4
11220,2024-10,409,146,224,39,404,5
11220,2024-11,356,94,228,34,351,5
11220,2024-12,380,107,228,45,377,3
11221,2020-01,498,159,256,83,489,9
11221,2020-02,422,131,216,75,415,7
11221,2020-03,402,122,216,64,396,6
11221,2020-04,386,132,187,67,376,10
11221,2020-05,432,140,217,75,416,16
11221,2020-06,431,164,200,67,423,8
11221,2020-07,461,181,224,56,450,11
11221,2020-08,461,175,221,65,452,9
11221,2020-09,453,187,211,55,440,13
11221,2020-10,468,178,209,81,461,7
11221,2020-11,422,168,181,73,405,17
11221,2020-12,383,133,187,63,376,7
11221,2021-01,433,163,191,79,422,11
11221,2021-02,327,121,136,70,320,7
11221,2021-03,386,132,188,66,373,12
11221,2021-04,397,148,185,64,388,9
11221,2021-05,459,157,216,86,451,8
11221,2021-06,462,167,204,91,455,7
11221,2021-07,437,159,208,70,425,12
11221,2021-08,476,170,221,85,472,4
11221,2021-09,521,180,256,85,517,4
11221,2021-10,477,172,227,78,465,12
11221,2021-11,466,142,226,98,458,8
11221,2021-12,430,180,171,79,418,12
11221,2022-01,499,151,260,88,492,7
11221,2022-02,388,142,182,64,382,6
11221,2022-03,454,177,188,89,447,7
11221,2022-04,508,189,209,110,502,6
11221,2022-05,468,176,215,77,458,10
11221,2022-06,541,200,251,90,536,5
11221,2022-07,566,212,254,100,556,10
11221,2022-08,517,181,238,98,508,9
11221,2022-09,494,177,229,88,488,6
11221,2022-10,505,190,220,95,497,8
11221,2022-11,479,164,226,89,469,10
11221,2022-12,388,131,173,84,387,1
11221,2023-01,489,182,206,101,483,6
11221,2023-02,416,129,197,90,413,3
11221,2023-03,502,188,191,123,488,14
11221,2023-04,486,151,227,108,478,8
11221,2023-05,521,192,234,95,509,12
11221,2023-06,551,199,243,109,540,11
11221,2023-07,491,186,229,76,479,12
11221,2023-08,493,139,264,90,488,5
11221,2023-09,449,149,210,90,438,11
11221,2023-10,487,176,221,90,480,7
11221,2023-11,403,125,193,85,399,4
11221,2023-12,467,141,240,86,463,4
11221,2024-01,409,133,192,84,403,6
11221,2024-02,393,125,187,81,386,7
11221,2024-03,404,138,184,82,397,7
11221,2024-04,416,149,189,78,411,5
11221,2024-05,415,132,203,80,410,5
11221,2024-06,485,174,228,83,481,4
11221,2024-07,471,138,225,108,462,9
11221,2024-08,436,155,203,78,432,4
11221,2024-09,455,140,236,79,444,11
11221,2024-10,472,130,245,97,466,6
11221,2024-11,431,138,216,77,424,7
11221,2024-12,387,97,226,64,380,7
11222,2020-01,145,53,67,25,144,1
11222,2020-02,157,51,74,32,156,1
11222,2020-03,126,44,54,28,124,2
11222,2020-04,119,37,59,23,115,4
11222,2020-05,150,41,81,28,150,0
11222,2020-06,161,60,71,30,159,2
11222,2020-07,220,69,114,37,218,2
11222,2020-08,215,76,107,32,213,2
11222,2020-09,165,72,75,18,164,1
11222,2020-10,184,64,84,36,180,4
11222,2020-11,168,61,85,22,167,1
11222,2020-12,160,54,77,29,157,3
11222,2021-01,163,59,66,38,162,1
11222,2021-02,121,43,62,16,115,6
11222,2021-03,146,39,74,33,144,2
11222,2021-04,166,53,71,42,162,4
11222,2021-05,223,66,112,45,221,2
11222,2021-06,175,53,97,25,173,2
11222,2021-07,198,81,98,19,190,8
11222,2021-08,197,70,88,39,196,1
11222,2021-09,180,70,77,33,180,0
11222,2021-10,184,62,92,30,181,3
11222,2021-11,156,62,65,29,155,1
11222,2021-12,153,63,68,22,150,3
11222,2022-01,163,64,68,31,162,1
11222,2022-02,183,72,79,32,180,3
11222,2022-03,168,61,86,21,165,3
11222,2022-04,225,76,110,39,223,2
11222,2022-05,220,90,91,39,216,4
11222,2022-06,192,71,82,39,191,1
11222,2022-07,236,102,99,35,232,4
11222,2022-08,208,76,90,42,207,1
11222,2022-09,197,90,77,30,194,3
11222,2022-10,219,71,95,53,215,4
11222,2022-11,193,71,88,34,191,2
11222,2022-12,198,76,79,43,196,2
11222,2023-01,189,75,82,32,185,4
11222,2023-02,187,76,83,28,184,3
11222,2023-03,199,68,93,38,194,5
11222,2023-04,188,87,79,22,187,1
11222,2023-05,189,89,74,26,185,4
11222,2023-06,204,77,99,28,200,4
11222,2023-07,264,110,111,43,256,8
11222,2023-08,221,92,100,29,220,1
11222,2023-09,187,59,96,32,186,1
11222,2023-10,227,104,75,48,220,7
11222,2023-11,180,53,87,40,178,2
11222,2023-12,192,70,88,34,190,2
11222,2024-01,177,51,86,40,175,2
11222,2024-02,152,47,84,21,149,3
11222,2024-03,163,70,73,20,162,1
11222,2024-04,163,65,73,25,158,5
11222,2024-05,192,75,74,43,192,0
11222,2024-06,245,90,103,52,238,7
11222,2024-07,201,74,97,30,199,2
11222,2024-08,181,57,87,37,178,3
11222,2024-09,173,65,82,26,171,2
11222,2024-10,214,68,106,40,210,4
11222,2024-11,160,46,82,32,159,1
11222,2024-12,152,41,71,40,152,0
11223,2020-01,197,67,103,27,195,2
11223,2020-02,222,83,110,29,216,6
11223,2020-03,218,82,102,34,212,6
11223,2020-04,137,47,68,22,132,5
11223,2020-05,176,58,95,23,174,2
11223,2020-06,153,59,65,29,152,1
11223,2020-07,184,47,113,24,182,2
11223,2020-08,214,68,108,38,212,2
11223,2020-09,216,77,116,23,214,2
11223,2020-10,222,83,105,34,218,4
11223,2020-11,188,68,94,26,184,4
11223,2020-12,188,50,111,27,185,3
11223,2021-01,196,60,103,33,194,2
11223,2021-02,167,44,98,25,165,2
11223,2021-03,199,67,92,40,196,3
11223,2021-04,194,62,101,31,191,3
11223,2021-05,201,58,103,40,200,1
11223,2021-06,186,62,102,22,182,4
11223,2021-07,231,80,116,35,226,5
11223,2021-08,180,61,93,26,179,1
11223,2021-09,190,73,76,41,190,0
11223,2021-10,203,66,91,46,203,0
11223,2021-11,231,85,122,24,228,3
11223,2021-12,235,103,103,29,231,4
11223,2022-01,215,72,113,30,211,4
11223,2022-02,201,66,96,39,199,2
11223,2022-03,260,71,148,41,259,1
11223,2022-04,246,70,130,46,244,2
11223,2022-05,223,76,118,29,221,2
11223,2022-06,275,74,168,33,273,2
11223,2022-07,302,84,182,36,297,5
11223,2022-08,269,91,147,31,266,3
11223,2022-09,258,90,131,37,255,3
11223,2022-10,275,83,138,54,274,1
11223,2022-11,268,77,157,34,267,1
11223,2022-12,247,89,123,35,242,5
11223,2023-01,230,87,121,22,225,5
11223,2023-02,235,72,135,28,234,1
11223,2023-03,263,88,128,47,259,4
11223,2023-04,231,76,123,32,230,1
11223,2023-05,280,91,153,36,275,5
11223,2023-06,279,88,138,53,275,4
11223,2023-07,306,98,171,37,299,7
11223,2023-08,245,81,129,35,243,2
11223,2023-09,247,93,125,29,247,0
11223,2023-10,265,84,127,54,264,1
11223,2023-11,220,77,115,28,219,1
11223,2023-12,239,98,112,29,236,3
11223,2024-01,244,91,116,37,243,1
11223,2024-02,234,73,120,41,230,4
11223,2024-03,255,91,119,45,253,2
11223,2024-04,237,79,131,27,233,4
11223,2024-05,271,101,131,39,267,4
11223,2024-06,253,94,118,41,245,8
11223,2024-07,265,90,135,40,262,3
11223,2024-08,231,74,122,35,230,1
11223,2024-09,233,92,106,35,229,4
11223,2024-10,271,90,136,45,270,1
11223,2024-11,218,68,104,46,217,1
11223,2024-12,205,67,106,32,205,0
11224,2020-01,254,82,131,41,254,0
11224,2020-02,240,74,125,41,237,3
11224,2020-03,240,88,109,43,237,3
11224,2020-04,165,57,83,25,165,0
11224,2020-05,233,70,137,26,229,4
11224,2020-06,227,78,110,39,223,4
11224,2020-07,255,88,123,44,252,3
11224,2020-08,260,90,131,39,258,2
11224,2020-09,226,99,86,41,221,5
11224,2020-10,215,84,97,34,215,0
11224,2020-11,217,68,114,35,216,1
11224,2020-12,249,81,127,41,249,0
11224,2021-01,239,82,115,42,235,4
11224,2021-02,191,73,76,42,189,2
11224,2021-03,282,106,120,56,277,5
11224,2021-04,247,67,119,61,246,1
11224,2021-05,277,98,129,50,277,0
11224,2021-06,330,136,140,54,325,5
11224,2021-07,347,119,163,65,341,6
11224,2021-08,286,102,133,51,281,5
11224,2021-09,254,87,113,54,253,1
11224,2021-10,290,85,143,62,286,4
11224,2021-11,262,81,132,49,262,0
11224,2021-12,248,79,116,53,246,2
11224,2022-01,275,85,144,46,272,3
11224,2022-02,251,78,137,36,248,3
11224,2022-03,297,85,166,46,291,6
11224,2022-04,324,94,181,49,320,4
11224,2022-05,327,101,151,75,323,4
11224,2022-06,351,133,166,52,349,2
11224,2022-07,416,145,206,65,412,4
11224,2022-08,382,128,177,77,379,3
11224,2022-09,338,111,176,51,338,0
11224,2022-10,332,121,143,68,328,4
11224,2022-11,276,101,119,56,275,1
11224,2022-12,264,76,141,47,260,4
11224,2023-01,338,120,166,52,333,5
11224,2023-02,245,62,127,56,244,1
11224,2023-03,263,79,127,57,263,0
11224,2023-04,322,107,156,59,319,3
11224,2023-05,315,106,145,64,313,2
11224,2023-06,343,134,152,57,341,2
11224,2023-07,408,157,194,57,406,2
11224,2023-08,388,138,186,64,382,6
11224,2023-09,339,124,165,50,334,5
11224,2023-10,343,101,183,59,343,0
11224,2023-11,309,103,164,42,306,3
11224,2023-12,340,108,171,61,335,5
11224,2024-01,320,116,138,66,316,4
11224,2024-02,292,113,148,31,291,1
11224,2024-03,323,106,172,45,321,2
11224,2024-04,295,84,153,58,294,1
11224,2024-05,338,102,176,60,332,6
11224,2024-06,452,147,239,66,444,8
11224,2024-07,443,140,229,74,439,4
11224,2024-08,385,116,194,75,384,1
11224,2024-09,313,96,163,54,311,2
11224,2024-10,394,121,208,65,391,3
11224,2024-11,336,112,166,58,332,4
11224,2024-12,287,100,131,56,284,3
11225,2020-01,272,96,142,34,270,2
11225,2020-02,222,88,98,36,218,4
11225,2020-03,202,55,112,35,199,3
11225,2020-04,160,37,87,36,157,3
11225,2020-05,229,67,122,40,226,3
11225,2020-06,212,74,113,25,207,5
11225,2020-07,231,71,124,36,228,3
11225,2020-08,253,73,144,36,249,4
11225,2020-09,248,83,121,44,246,2
11225,2020-10,228,67,129,32,228,0
11225,2020-11,243,85,121,37,237,6
11225,2020-12,235,67,133,35,232,3
11225,2021-01,243,73,130,40,242,1
11225,2021-02,229,63,127,39,225,4
11225,2021-03,261,76,143,42,255,6
11225,2021-04,210,57,116,37,209,1
11225,2021-05,277,88,131,58,275,2
11225,2021-06,248,72,138,38,245,3
11225,2021-07,252,82,127,43,249,3
11225,2021-08,263,75,138,50,263,0
11225,2021-09,274,78,139,57,272,2
11225,2021-10,341,116,149,76,336,5
11225,2021-11,293,87,136,70,287,6
11225,2021-12,325,111,163,51,321,4
11225,2022-01,267,79,125,63,265,2
11225,2022-02,300,99,144,57,297,3
11225,2022-03,339,118,152,69,334,5
11225,2022-04,297,88,135,74,297,0
11225,2022-05,324,89,152,83,322,2
11225,2022-06,315,69,177,69,313,2
11225,2022-07,307,100,143,64,306,1
11225,2022-08,318,95,148,75,317,1
11225,2022-09,284,91,127,66,276,8
11225,2022-10,299,91,140,68,297,2
11225,2022-11,336,97,177,62,333,3
11225,2022-12,297,91,144,62,290,7
11225,2023-01,327,93,174,60,322,5
11225,2023-02,266,71,114,81,266,0
11225,2023-03,293,89,148,56,288,5
11225,2023-04,305,102,144,59,301,4
11225,2023-05,318,87,162,69,315,3
11225,2023-06,308,82,154,72,306,2
11225,2023-07,306,91,155,60,301,5
11225,2023-08,346,110,177,59,341,5
11225,2023-09,320,92,170,58,317,3
11225,2023-10,315,100,142,73,313,2
11225,2023-11,284,80,149,55,283,1
11225,2023-12,284,64,156,64,279,5
11225,2024-01,301,81,160,60,298,3
11225,2024-02,252,62,127,63,251,1
11225,2024-03,271,75,145,51,268,3
11225,2024-04,263,68,143,52,261,2
11225,2024-05,244,66,126,52,243,1
11225,2024-06,246,57,125,64,245,1
11225,2024-07,234,65,131,38,232,2
11225,2024-08,265,65,144,56,264,1
11225,2024-09,254,80,123,51,252,2
11225,2024-10,253,62,132,59,251,2
11225,2024-11,269,69,158,42,267,2
11225,2024-12,221,56,121,44,219,2
11226,2020-01,485,168,253,64,480,5
11226,2020-02,395,127,191,77,389,6
11226,2020-03,399,129,200,70,397,2
11226,2020-04,284,106,138,40,281,3
11226,2020-05,411,150,203,58,400,11
11226,2020-06,409,144,189,76,404,5
11226,2020-07,416,125,218,73,410,6
11226,2020-08,469,171,211,87,463,6
11226,2020-09,395,150,169,76,391,4
11226,2020-10,415,152,196,67,409,6
11226,2020-11,455,156,217,82,453,2
11226,2020-12,374,138,162,74,366,8
11226,2021-01,458,156,234,68,451,7
11226,2021-02,386,128,193,65,383,2
11226,2021-03,483,167,226,90,474,7
11226,2021-04,439,154,228,57,428,8
11226,2021-05,409,130,211,68,405,4
11226,2021-06,431,159,196,76,423,8
11226,2021-07,498,197,200,101,493,5
11226,2021-08,458,161,217,80,455,3
11226,2021-09,476,147,236,93,473,3
11226,2021-10,546,150,302,94,542,4
11226,2021-11,520,189,239,92,509,11
11226,2021-12,474,184,220,70,465,9
11226,2022-01,437,163,195,79,415,22
11226,2022-02,393,146,170,77,388,5
11226,2022-03,477,170,221,86,474,3
11226,2022-04,456,159,220,77,448,8
11226,2022-05,483,168,236,79,477,6
11226,2022-06,479,170,227,82,473,6
11226,2022-07,486,179,213,94,480,6
11226,2022-08,559,179,255,125,552,7
11226,2022-09,490,178,217,95,481,9
11226,2022-10,542,191,257,94,535,7
11226,2022-11,535,165,262,108,531,4
11226,2022-12,506,154,263,89,500,6
11226,2023-01,529,179,253,97,515,14
11226,2023-02,456,144,236,76,453,3
11226,2023-03,592,191,289,112,591,1
11226,2023-04,566,176,282,108,561,5
11226,2023-05,494,167,232,95,486,8
11226,2023-06,547,165,258,124,544,3
11226,2023-07,519,175,233,111,514,5
11226,2023-08,526,170,257,99,520,6
11226,2023-09,533,175,251,107,526,7
11226,2023-10,593,194,285,114,588,5
11226,2023-11,538,185,261,92,526,12
11226,2023-12,505,169,254,82,498,7
11226,2024-01,541,182,263,96,534,7
11226,2024-02,492,167,244,81,487,5
11226,2024-03,538,169,274,95,533,5
11226,2024-04,567,190,259,118,560,7
11226,2024-05,610,220,276,114,603,7
11226,2024-06,595,188,288,119,589,6
11226,2024-07,572,175,287,110,570,2
11226,2024-08,587,191,277,119,581,6
11226,2024-09,546,172,277,97,536,10
11226,2024-10,569,188,260,121,566,3
11226,2024-11,527,167,256,104,525,2
11226,2024-12,537,156,282,99,528,9
11228,2020-01,84,31,36,17,84,0
11228,2020-02,87,36,38,13,86,1
11228,2020-03,82,31,38,13,80,2
11228,2020-04,69,18,40,11,69,0
11228,2020-05,93,27,51,15,92,1
11228,2020-06,77,21,42,14,75,2
11228,2020-07,97,24,56,17,97,0
11228,2020-08,115,47,54,14,115,0
11228,2020-09,89,35,37,17,88,1
11228,2020-10,92,30,40,22,91,1
11228,2020-11,105,36,45,24,104,1
11228,2020-12,85,26,41,18,85,0
11228,2021-01,86,30,43,13,85,1
11228,2021-02,81,27,33,21,79,2
11228,2021-03,101,37,47,17,98,2
11228,2021-04,87,28,39,20,86,1
11228,2021-05,85,19,57,9,85,0
11228,2021-06,110,30,60,20,107,3
11228,2021-07,91,33,38,20,89,2
11228,2021-08,91,29,42,20,90,1
11228,2021-09,86,23,49,14,86,0
11228,2021-10,89,28,39,22,89,0
11228,2021-11,81,22,39,20,80,1
11228,2021-12,115,46,57,12,115,0
11228,2022-01,95,24,53,18,94,1
11228,2022-02,81,27,41,13,79,2
11228,2022-03,88,29,51,8,85,3
11228,2022-04,95,28,54,13,94,1
11228,2022-05,99,32,55,12,98,1
11228,2022-06,111,36,61,14,110,1
11228,2022-07,114,35,64,15,114,0
11228,2022-08,111,30,67,14,109,2
11228,2022-09,120,46,54,20,119,1
11228,2022-10,96,27,51,18,96,0
11228,2022-11,93,27,52,14,93,0
11228,2022-12,100,32,62,6,99,1
11228,2023-01,99,33,53,13,98,1
11228,2023-02,89,28,44,17,87,2
11228,2023-03,94,27,57,10,92,2
11228,2023-04,112,41,61,10,111,1
11228,2023-05,112,36,60,16,111,1
11228,2023-06,87,26,45,16,87,0
11228,2023-07,100,31,51,18,100,0
11228,2023-08,95,36,47,12,95,0
11228,2023-09,92,38,43,11,89,3
11228,2023-10,91,35,36,20,91,0
11228,2023-11,98,34,45,19,97,1
11228,2023-12,122,32,65,25,121,1
11228,2024-01,101,35,52,14,99,2
11228,2024-02,99,32,55,12,98,1
11228,2024-03,95,40,45,10,94,1
11228,2024-04,91,30,49,12,89,2
11228,2024-05,110,29,58,23,108,2
11228,2024-06,100,35,56,9,100,0
11228,2024-07,88,26,48,14,86,2
11228,2024-08,100,29,57,14,99,1
11228,2024-09,115,34,58,23,111,4
11228,2024-10,109,41,49,19,109,0
11228,2024-11,81,30,41,10,81,0
11228,2024-12,80,29,38,13,80,0
11229,2020-01,216,74,106,36,208,8
11229,2020-02,190,60,107,23,186,4
11229,2020-03,174,62,91,21,174,0
11229,2020-04,148,55,70,23,145,3
11229,2020-05,190,77,90,23,184,6
11229,2020-06,171,59,91,21,169,2
11229,2020-07,171,53,87,31,168,3
11229,2020-08,166,69,72,25,161,5
11229,2020-09,182,68,93,21,179,3
11229,2020-10,179,55,96,28,178,1
11229,2020-11,160,54,81,25,159,1
11229,2020-12,157,51,81,25,154,3
11229,2021-01,203,74,111,18,202,1
11229,2021-02,153,38,92,23,147,6
11229,2021-03,204,79,106,19,200,3
11229,2021-04,176,58,92,26,163,4
11229,2021-05,185,65,88,32,182,3
11229,2021-06,168,62,78,28,165,3
11229,2021-07,194,76,96,22,193,1
11229,2021-08,199,64,104,31,196,3
11229,2021-09,195,60,108,27,193,2
11229,2021-10,189,61,93,35,187,2
11229,2021-11,230,81,119,30,226,4
11229,2021-12,232,82,119,31,227,5
11229,2022-01,210,76,99,35,207,3
11229,2022-02,203,72,101,30,201,2
11229,2022-03,251,90,121,40,248,3
11229,2022-04,221,81,109,31,221,0
11229,2022-05,265,88,147,30,262,3
11229,2022-06,261,96,128,37,258,3
11229,2022-07,302,107,158,37,299,3
11229,2022-08,265,90,136,39,259,6
11229,2022-09,261,99,134,28,258,3
11229,2022-10,272,106,133,33,269,3
11229,2022-11,260,102,121,37,254,6
11229,2022-12,237,79,123,35,235,2
11229,2023-01,256,84,130,42,250,6
11229,2023-02,220,82,114,24,215,5
11229,2023-03,247,99,110,38,246,1
11229,2023-04,236,90,113,33,234,2
11229,2023-05,240,82,115,43,236,4
11229,2023-06,231,86,111,34,229,2
11229,2023-07,253,99,122,32,252,1
11229,2023-08,250,93,121,36,246,4
11229,2023-09,215,60,122,33,215,0
11229,2023-10,255,84,140,31,250,5
11229,2023-11,247,109,112,26,245,2
11229,2023-12,237,71,127,39,234,3
11229,2024-01,244,98,123,23,241,3
11229,2024-02,255,92,134,29,252,3
11229,2024-03,289,91,156,42,288,1
11229,2024-04,257,85,125,47,256,1
11229,2024-05,311,116,142,53,308,3
11229,2024-06,317,98,168,51,315,2
11229,2024-07,306,87,174,45,302,4
11229,2024-08,259,71,156,32,259,0
11229,2024-09,310,115,140,55,310,0
11229,2024-10,279,99,141,39,276,3
11229,2024-11,296,75,173,48,294,2
11229,2024-12,256,88,139,29,256,0
11230,2020-01,222,59,134,29,219,3
11230,2020-02,191,56,101,34,188,3
11230,2020-03,164,56,82,26,158,6
11230,2020-04,130,43,67,20,129,1
11230,2020-05,169,52,80,37,167,2
11230,2020-06,177,56,83,38,176,1
11230,2020-07,205,65,102,38,201,4
11230,2020-08,175,50,98,27,174,1
11230,2020-09,186,64,88,34,184,2
11230,2020-10,188,56,86,46,185,3
11230,2020-11,190,68,91,31,189,1
11230,2020-12,184,82,77,25,180,4
11230,2021-01,166,39,100,27,166,0
11230,2021-02,137,45,66,26,137,0
11230,2021-03,158,65,62,31,158,0
11230,2021-04,168,54,85,29,166,1
11230,2021-05,195,66,103,26,191,4
11230,2021-06,146,48,76,22,142,4
11230,2021-07,220,78,105,37,219,1
11230,2021-08,190,67,82,41,189,1
11230,2021-09,186,71,93,22,179,7
11230,2021-10,229,75,111,43,224,5
11230,2021-11,210,86,95,29,208,2
11230,2021-12,207,84,91,32,204,3
11230,2022-01,184,72,79,33,179,5
11230,2022-02,176,88,68,20,173,3
11230,2022-03,191,77,87,27,188,3
11230,2022-04,192,62,107,23,190,2
11230,2022-05,211,71,106,34,206,5
11230,2022-06,186,61,86,39,185,1
11230,2022-07,219,75,106,38,216,3
11230,2022-08,204,78,96,30,202,2
11230,2022-09,215,62,112,41,213,2
11230,2022-10,202,65,108,29,200,2
11230,2022-11,193,73,86,34,189,4
11230,2022-12,207,65,112,30,205,2
11230,2023-01,186,63,100,23,184,2
11230,2023-02,138,41,73,24,138,0
11230,2023-03,220,75,108,37,217,3
11230,2023-04,207,67,111,29,206,1
11230,2023-05,218,72,110,36,215,3
11230,2023-06,212,79,86,47,208,4
11230,2023-07,203,58,113,32,202,1
11230,2023-08,205,72,87,46,203,2
11230,2023-09,210,62,109,39,207,3
11230,2023-10,230,87,105,38,227,3
11230,2023-11,208,62,104,42,207,1
11230,2023-12,201,69,101,31,200,1
11230,2024-01,184,62,101,21,181,3
11230,2024-02,205,78,104,23,203,2
11230,2024-03,185,61,104,20,185,0
11230,2024-04,184,66,87,31,182,2
11230,2024-05,216,78,102,36,214,2
11230,2024-06,238,82,113,43,234,4
11230,2024-07,240,95,114,31,239,1
11230,2024-08,203,70,107,26,202,1
11230,2024-09,220,78,103,39,219,1
11230,2024-10,236,75,132,29,234,2
11230,2024-11,180,70,92,18,173,7
11230,2024-12,176,68,71,37,175,1
11231,2020-01,134,48,70,16,132,2
11231,2020-02,155,55,81,19,152,3
11231,2020-03,126,42,66,18,125,1
11231,2020-04,94,33,46,15,92,2
11231,2020-05,139,46,75,18,138,1
11231,2020-06,120,40,58,22,118,2
11231,2020-07,136,38,75,23,135,1
11231,2020-08,130,45,72,13,130,0
11231,2020-09,149,52,79,18,149,0
11231,2020-10,134,54,68,12,133,1
11231,2020-11,142,45,74,23,140,2
11231,2020-12,100,40,47,13,99,1
11231,2021-01,109,48,48,13,108,1
11231,2021-02,121,52,51,18,121,0
11231,2021-03,125,39,59,27,125,0
11231,2021-04,104,39,51,14,102,2
11231,2021-05,120,41,74,5,118,2
11231,2021-06,128,45,68,15,126,2
11231,2021-07,125,51,63,11,123,2
11231,2021-08,153,58,72,23,149,4
11231,2021-09,130,52,60,18,129,1
11231,2021-10,167,64,76,27,166,1
11231,2021-11,122,49,61,12,121,1
11231,2021-12,144,47,74,23,144,0
11231,2022-01,125,41,63,21,124,1
11231,2022-02,116,44,58,14,114,2
11231,2022-03,139,51,66,22,135,4
11231,2022-04,154,51,84,19,152,2
11231,2022-05,155,46,89,20,154,1
11231,2022-06,160,49,88,23,160,0
11231,2022-07,158,54,86,18,156,2
11231,2022-08,191,77,99,15,185,6
11231,2022-09,179,64,82,33,176,3
11231,2022-10,175,66,86,23,174,1
11231,2022-11,178,67,86,25,176,2
11231,2022-12,125,42,53,30,125,0
11231,2023-01,180,53,108,19,179,1
11231,2023-02,139,48,71,20,137,2
11231,2023-03,191,59,108,24,187,4
11231,2023-04,177,55,105,17,176,1
11231,2023-05,191,62,110,19,188,3
11231,2023-06,174,63,87,24,172,2
11231,2023-07,210,76,106,28,207,3
11231,2023-08,240,88,132,20,238,2
11231,2023-09,178,58,91,29,176,2
11231,2023-10,179,53,101,25,179,0
11231,2023-11,185,75,91,19,182,3
11231,2023-12,168,57,85,26,167,1
11231,2024-01,173,58,98,17,172,1
11231,2024-02,163,62,83,18,158,5
11231,2024-03,181,67,95,19,181,0
11231,2024-04,196,63,104,29,196,0
11231,2024-05,208,60,124,24,207,1
11231,2024-06,205,64,117,24,205,0
11231,2024-07,180,68,87,25,178,2
11231,2024-08,225,73,122,30,224,1
11231,2024-09,217,74,109,34,214,3
11231,2024-10,224,52,145,27,223,1
11231,2024-11,220,69,122,29,220,0
11231,2024-12,191,62,88,41,189,2
11232,2020-01,105,36,59,10,103,2
11232,2020-02,130,48,65,17,126,4
11232,2020-03,152,49,89,14,150,2
11232,2020-04,82,27,46,9,82,0
11232,2020-05,124,33,72,19,121,3
11232,2020-06,91,29,50,12,89,2
11232,2020-07,112,30,63,19,111,1
11232,2020-08,139,46,83,10,135,4
11232,2020-09,120,33,68,19,119,1
11232,2020-10,121,37,73,11,119,1
11232,2020-11,108,29,66,13,106,2
11232,2020-12,117,39,66,12,115,2
11232,2021-01,130,38,68,24,130,0
11232,2021-02,91,22,53,16,91,0
11232,2021-03,117,40,58,19,113,4
11232,2021-04,130,36,76,18,129,1
11232,2021-05,140,41,74,25,140,0
11232,2021-06,134,26,88,20,133,1
11232,2021-07,138,48,64,26,137,1
11232,2021-08,151,56,78,17,148,3
11232,2021-09,92,32,47,13,89,3
11232,2021-10,114,37,64,13,111,3
11232,2021-11,125,45,63,17,123,2
11232,2021-12,138,64,58,16,134,4
11232,2022-01,136,55,68,13,135,1
11232,2022-02,130,59,58,13,128,2
11232,2022-03,135,48,69,18,132,3
11232,2022-04,136,49,67,20,135,1
11232,2022-05,150,54,76,20,150,0
11232,2022-06,148,53,75,20,146,2
11232,2022-07,147,50,77,20,144,3
11232,2022-08,161,63,82,16,160,1
11232,2022-09,161,59,74,28,160,1
11232,2022-10,158,56,76,26,153,5
11232,2022-11,130,48,67,15,127,3
11232,2022-12,132,40,72,20,130,2
11232,2023-01,155,47,84,24,153,2
11232,2023-02,137,34,82,21,134,3
11232,2023-03,163,49,93,21,160,3
11232,2023-04,157,43,91,23,155,2
11232,2023-05,155,51,86,18,154,1
11232,2023-06,151,44,82,25,151,0
11232,2023-07,142,38,81,23,140,2
11232,2023-08,147,54,72,21,143,4
11232,2023-09,157,59,71,27,155,2
11232,2023-10,164,52,84,28,164,0
11232,2023-11,150,38,89,23,148,2
11232,2023-12,182,46,106,30,182,0
11232,2024-01,169,52,96,21,168,1
11232,2024-02,135,48,73,14,131,4
11232,2024-03,158,45,92,21,157,1
11232,2024-04,150,51,84,15,150,0
11232,2024-05,185,58,106,21,182,3
11232,2024-06,160,52,84,24,156,4
11232,2024-07,158,40,93,25,157,1
11232,2024-08,149,51,77,21,149,0
11232,2024-09,152,41,90,21,151,1
11232,2024-10,168,57,95,16,167,1
11232,2024-11,133,48,67,18,132,1
11232,2024-12,126,26,76,24,126,0
11233,2020-01,483,155,236,92,475,8
11233,2020-02,441,146,205,90,434,7
11233,2020-03,485,154,231,100,478,7
11233,2020-04,399,113,191,95,389,10
11233,2020-05,420,117,216,87,414,6
11233,2020-06,419,144,190,85,413,6
11233,2020-07,443,155,195,93,441,2
11233,2020-08,505,177,246,82,501,4
11233,2020-09,413,154,182,77,406,7
11233,2020-10,447,170,203,74,442,5
11233,2020-11,369,140,171,58,366,3
11233,2020-12,434,141,223,70,431,3
11233,2021-01,368,164,150,54,363,5
11233,2021-02,331,121,140,70,327,4
11233,2021-03,397,138,191,68,384,12
11233,2021-04,352,106,170,76,346,6
11233,2021-05,438,149,220,69,422,16
11233,2021-06,444,136,207,101,439,5
11233,2021-07,437,137,202,98,430,7
11233,2021-08,450,152,198,100,444,6
11233,2021-09,456,159,198,99,448,8
11233,2021-10,506,181,219,106,490,16
11233,2021-11,535,169,249,117,529,6
11233,2021-12,528,175,240,113,522,6
11233,2022-01,494,158,236,100,489,5
11233,2022-02,436,164,192,80,428,8
11233,2022-03,509,171,240,98,504,5
11233,2022-04,560,166,268,126,555,5
11233,2022-05,589,197,269,123,580,9
11233,2022-06,564,183,264,117,558,6
11233,2022-07,605,206,283,116,599,6
11233,2022-08,545,177,259,109,535,10
11233,2022-09,504,166,233,105,500,4
11233,2022-10,528,189,229,110,524,4
11233,2022-11,510,158,240,112,507,3
11233,2022-12,510,171,234,105,499,11
11233,2023-01,540,172,260,108,531,9
11233,2023-02,498,174,220,104,489,9
11233,2023-03,518,183,236,99,507,11
11233,2023-04,511,190,224,97,502,9
11233,2023-05,554,191,240,123,551,3
11233,2023-06,523,175,242,106,512,11
11233,2023-07,570,198,261,111,566,4
11233,2023-08,513,152,269,92,512,1
11233,2023-09,498,132,251,115,492,6
11233,2023-10,521,160,251,110,514,7
11233,2023-11,520,160,254,106,512,8
11233,2023-12,558,179,277,102,553,5
11233,2024-01,543,161,269,113,534,9
11233,2024-02,460,148,226,86,452,8
11233,2024-03,515,164,262,89,510,5
11233,2024-04,469,150,246,73,456,13
11233,2024-05,543,171,265,107,539,4
11233,2024-06,551,176,282,93,547,4
11233,2024-07,607,187,306,114,602,5
11233,2024-08,576,180,298,98,569,7
11233,2024-09,578,157,299,122,570,8
11233,2024-10,618,150,340,128,610,8
11233,2024-11,537,150,273,114,534,3
11233,2024-12,446,111,240,95,441,5
11234,2020-01,287,110,141,36,285,2
11234,2020-02,258,74,147,37,254,4
11234,2020-03,248,82,123,43,246,2
11234,2020-04,187,50,102,35,186,1
11234,2020-05,239,79,111,49,237,2
11234,2020-06,279,95,138,46,271,8
11234,2020-07,301,95,149,57,299,2
11234,2020-08,267,70,136,61,263,4
11234,2020-09,299,119,131,49,298,1
11234,2020-10,291,95,149,47,291,0
11234,2020-11,285,110,137,38,283,2
11234,2020-12,327,108,163,56,325,2
11234,2021-01,276,102,126,48,276,0
11234,2021-02,252,75,131,46,248,4
11234,2021-03,251,82,117,52,247,4
11234,2021-04,269,75,127,67,267,1
11234,2021-05,328,112,151,65,326,2
11234,2021-06,282,103,122,57,280,2
11234,2021-07,301,99,129,73,301,0
11234,2021-08,343,92,190,61,342,1
11234,2021-09,292,100,146,46,289,3
11234,2021-10,339,110,161,68,337,2
11234,2021-11,288,102,125,61,285,3
11234,2021-12,328,112,148,68,319,9
11234,2022-01,296,108,144,44,294,2
11234,2022-02,295,97,143,55,288,7
11234,2022-03,307,103,158,46,307,0
11234,2022-04,320,100,157,63,318,2
11234,2022-05,301,88,146,67,299,2
11234,2022-06,358,106,191,61,356,2
11234,2022-07,405,148,187,70,401,4
11234,2022-08,387,140,188,59,383,4
11234,2022-09,405,127,207,71,400,5
11234,2022-10,368,114,192,62,367,1
11234,2022-11,376,123,189,64,372,4
11234,2022-12,435,129,241,65,431,4
11234,2023-01,401,131,204,66,399,2
11234,2023-02,348,106,194,48,347,1
11234,2023-03,367,112,186,69,365,2
11234,2023-04,381,105,207,69,375,6
11234,2023-05,389,125,192,72,387,2
11234,2023-06,397,127,205,65,394,3
11234,2023-07,458,158,229,71,456,2
11234,2023-08,449,126,257,66,449,0
11234,2023-09,427,133,218,76,423,4
11234,2023-10,420,118,224,78,418,2
11234,2023-11,417,104,248,65,417,0
11234,2023-12,382,115,220,47,380,2
11234,2024-01,399,124,207,68,392,7
11234,2024-02,359,90,226,43,355,4
11234,2024-03,432,120,254,58,428,4
11234,2024-04,406,140,204,62,405,1
11234,2024-05,451,126,240,85,445,6
11234,2024-06,467,118,272,77,464,3
11234,2024-07,378,103,208,67,372,6
11234,2024-08,450,142,246,62,448,2
11234,2024-09,437,131,241,65,430,7
11234,2024-10,413,93,240,80,407,6
11234,2024-11,416,124,241,51,412,4
11234,2024-12,352,96,206,50,347,5
11235,2020-01,267,91,146,30,262,5
11235,2020-02,259,92,136,31,258,1
11235,2020-03,270,102,130,38,270,0
11235,2020-04,157,45,88,24,157,0
11235,2020-05,250,84,141,25,247,3
11235,2020-06,231,79,123,29,229,2
11235,2020-07,274,79,150,45,270,4
11235,2020-08,221,71,123,27,219,2
11235,2020-09,235,67,123,45,232,3
11235,2020-10,241,83,117,41,239,2
11235,2020-11,238,86,132,20,235,3
11235,2020-12,216,84,109,23,214,2
11235,2021-01,206,72,110,24,205,1
11235,2021-02,184,63,100,21,180,4
11235,2021-03,221,65,118,38,220,1
11235,2021-04,227,76,117,34,224,3
11235,2021-05,231,79,113,39,229,2
11235,2021-06,246,74,128,44,244,2
11235,2021-07,232,106,108,18,227,5
11235,2021-08,262,100,126,36,259,3
11235,2021-09,222,82,108,32,218,4
11235,2021-10,267,92,135,40,263,4
11235,2021-11,251,101,115,35,248,3
11235,2021-12,286,104,141,41,280,6
11235,2022-01,268,108,125,35,264,4
11235,2022-02,265,121,120,24,256,9
11235,2022-03,294,117,135,42,288,6
11235,2022-04,282,110,136,36,277,5
11235,2022-05,313,108,150,55,310,3
11235,2022-06,308,109,145,54,304,4
11235,2022-07,383,137,195,51,381,2
11235,2022-08,326,133,149,44,323,3
11235,2022-09,271,87,133,51,267,4
11235,2022-10,281,111,133,37,277,4
11235,2022-11,254,96,121,37,249,5
11235,2022-12,257,102,117,38,255,2
11235,2023-01,290,126,127,37,289,1
11235,2023-02,208,83,99,26,205,3
11235,2023-03,274,110,128,36,273,1
11235,2023-04,286,125,129,32,283,3
11235,2023-05,286,123,132,31,283,3
11235,2023-06,259,118,109,32,256,3
11235,2023-07,248,91,113,44,244,4
11235,2023-08,264,109,123,32,261,3
11235,2023-09,274,115,138,21,271,3
11235,2023-10,323,139,142,42,315,8
11235,2023-11,281,110,142,29,276,5
11235,2023-12,258,101,122,35,254,4
11235,2024-01,283,125,132,26,281,2
11235,2024-02,238,94,111,33,238,0
11235,2024-03,263,88,133,42,263,0
11235,2024-04,290,112,142,36,286,4
11235,2024-05,309,114,148,47,307,2
11235,2024-06,294,102,144,48,292,2
11235,2024-07,306,117,146,43,303,3
11235,2024-08,286,110,128,48,282,4
11235,2024-09,269,90,148,31,266,3
11235,2024-10,301,106,146,49,297,4
11235,2024-11,240,88,122,30,239,1
11235,2024-12,237,85,108,44,237,0
11236,2020-01,369,128,184,57,361,8
11236,2020-02,362,99,187,76,359,3
11236,2020-03,325,91,173,61,321,4
11236,2020-04,227,63,107,57,222,5
11236,2020-05,264,87,123,54,262,2
11236,2020-06,329,112,148,69,328,1
11236,2020-07,435,163,182,90,434,1
11236,2020-08,432,143,202,87,428,4
11236,2020-09,371,104,178,89,365,6
11236,2020-10,395,130,191,74,390,5
11236,2020-11,336,128,134,74,332,4
11236,2020-12,328,90,170,68,326,2
11236,2021-01,327,101,147,79,324,3
11236,2021-02,323,110,143,70,319,4
11236,2021-03,391,102,202,87,386,5
11236,2021-04,331,100,156,75,330,1
11236,2021-05,454,135,226,93,446,8
11236,2021-06,345,114,150,81,340,5
11236,2021-07,406,134,179,93,405,1
11236,2021-08,449,132,215,102,446,3
11236,2021-09,448,164,182,102,442,6
11236,2021-10,478,170,193,115,472,6
11236,2021-11,385,138,153,94,384,1
11236,2021-12,397,117,188,92,388,9
11236,2022-01,395,148,168,79,384,11
11236,2022-02,356,138,141,77,347,9
11236,2022-03,484,180,206,98,477,7
11236,2022-04,450,163,211,76,443,7
11236,2022-05,428,137,205,86,424,4
11236,2022-06,436,130,193,113,433,3
11236,2022-07,437,146,201,90,432,5
11236,2022-08,470,154,221,95,469,1
11236,2022-09,362,110,170,82,354,8
11236,2022-10,370,107,194,69,367,3
11236,2022-11,440,137,230,73,435,5
11236,2022-12,441,139,203,99,435,6
11236,2023-01,480,148,237,95,478,2
11236,2023-02,413,126,206,81,410,3
11236,2023-03,453,139,202,112,447,6
11236,2023-04,456,150,191,115,446,10
11236,2023-05,482,157,213,112,478,4
11236,2023-06,455,160,206,89,450,5
11236,2023-07,450,147,216,87,444,6
11236,2023-08,456,148,207,101,451,5
11236,2023-09,381,114,183,84,376,5
11236,2023-10,394,131,171,92,390,4
11236,2023-11,423,136,191,96,421,2
11236,2023-12,443,155,195,93,439,4
11236,2024-01,432,129,211,92,426,6
11236,2024-02,430,145,182,103,426,4
11236,2024-03,442,153,211,78,439,3
11236,2024-04,441,142,216,83,434,7
11236,2024-05,463,159,203,101,454,9
11236,2024-06,481,170,223,88,477,4
11236,2024-07,456,148,216,92,451,5
11236,2024-08,443,153,191,99,440,3
11236,2024-09,432,141,173,118,420,12
11236,2024-10,430,121,211,98,424,6
11236,2024-11,414,116,209,89,411,3
11236,2024-12,337,103,162,72,335,2
11237,2020-01,227,77,119,31,221,6
11237,2020-02,268,106,122,40,261,7
11237,2020-03,188,79,92,17,185,3
11237,2020-04,162,64,77,21,159,3
11237,2020-05,186,67,92,27,183,3
11237,2020-06,215,82,98,35,207,8
11237,2020-07,239,93,110,36,232,7
11237,2020-08,225,90,109,26,217,8
11237,2020-09,242,87,121,34,238,4
11237,2020-10,227,99,94,34,221,6
11237,2020-11,241,103,107,31,238,3
11237,2020-12,255,101,123,31,246,9
11237,2021-01,229,89,112,28,219,10
11237,2021-02,175,75,82,18,171,4
11237,2021-03,218,86,102,30,206,9
11237,2021-04,196,75,81,40,196,0
11237,2021-05,229,86,99,44,224,5
11237,2021-06,253,102,121,30,247,6
11237,2021-07,283,109,134,40,282,1
11237,2021-08,229,92,107,30,227,2
11237,2021-09,267,106,122,39,261,6
11237,2021-10,246,104,110,32,242,4
11237,2021-11,275,105,125,45,269,6
11237,2021-12,233,102,108,23,226,7
11237,2022-01,237,82,130,25,236,1
11237,2022-02,208,99,82,27,205,3
11237,2022-03,253,100,113,40,253,0
11237,2022-04,271,95,137,39,268,3
11237,2022-05,314,109,170,35,311,3
11237,2022-06,315,130,146,39,313,2
11237,2022-07,333,145,146,42,329,4
11237,2022-08,366,140,173,53,361,5
11237,2022-09,318,132,148,38,315,3
11237,2022-10,426,156,219,51,422,4
11237,2022-11,291,112,134,45,289,2
11237,2022-12,259,101,128,30,254,5
11237,2023-01,311,133,137,41,305,6
11237,2023-02,244,107,114,23,237,7
11237,2023-03,287,115,132,40,282,5
11237,2023-04,301,112,162,27,296,5
11237,2023-05,387,146,191,50,382,5
11237,2023-06,356,155,158,43,342,14
11237,2023-07,313,134,136,43,309,4
11237,2023-08,312,127,148,37,303,9
11237,2023-09,318,140,141,37,308,10
11237,2023-10,374,165,147,62,367,7
11237,2023-11,324,137,141,46,315,9
11237,2023-12,283,121,126,36,276,7
11237,2024-01,320,121,163,36,313,7
11237,2024-02,292,105,164,23,283,9
11237,2024-03,372,139,190,43,365,7
11237,2024-04,360,105,207,48,351,9
11237,2024-05,409,177,192,40,395,14
11237,2024-06,309,103,160,46,306,3
11237,2024-07,337,119,165,53,329,8
11237,2024-08,355,129,188,38,345,10
11237,2024-09,348,121,184,43,341,7
11237,2024-10,323,106,175,42,318,5
11237,2024-11,339,106,182,51,328,11
11237,2024-12,289,104,158,27,285,4
11238,2020-01,236,76,122,38,229,7
11238,2020-02,206,75,95,36,200,6
11238,2020-03,191,50,100,41,190,1
11238,2020-04,172,60,84,28,172,0
11238,2020-05,190,68,102,20,185,5
11238,2020-06,177,61,85,31,173,4
11238,2020-07,241,84,118,39,240,1
11238,2020-08,238,87,121,30,234,4
11238,2020-09,229,83,121,25,226,3
11238,2020-10,213,65,112,36,209,4
11238,2020-11,205,68,112,25,199,6
11238,2020-12,200,64,109,27,200,0
11238,2021-01,142,37,82,23,141,1
11238,2021-02,132,33,74,25,129,2
11238,2021-03,186,50,100,36,185,0
11238,2021-04,214,58,128,28,212,2
11238,2021-05,183,50,107,26,180,3
11238,2021-06,204,63,107,34,202,2
11238,2021-07,186,55,101,30,182,4
11238,2021-08,199,69,98,32,197,2
11238,2021-09,207,72,94,41,202,5
11238,2021-10,239,76,120,43,237,2
11238,2021-11,177,53,94,30,174,3
11238,2021-12,188,62,99,27,186,2
11238,2022-01,182,52,99,31,180,2
11238,2022-02,157,54,67,36,151,6
11238,2022-03,240,78,110,52,240,0
11238,2022-04,208,58,114,36,202,6
11238,2022-05,259,91,131,37,256,3
11238,2022-06,240,63,132,45,236,4
11238,2022-07,241,91,102,48,240,1
11238,2022-08,229,85,102,42,225,4
11238,2022-09,229,72,112,45,225,4
11238,2022-10,242,76,127,39,236,6
11238,2022-11,196,72,88,36,193,3
11238,2022-12,193,69,99,25,191,2
11238,2023-01,193,61,96,36,191,2
11238,2023-02,170,57,79,34,167,3
11238,2023-03,203,68,107,28,199,4
11238,2023-04,218,70,109,39,215,3
11238,2023-05,209,62,104,43,207,2
11238,2023-06,237,74,108,55,236,1
11238,2023-07,220,77,102,41,218,2
11238,2023-08,240,79,121,40,237,3
11238,2023-09,248,85,137,26,246,2
11238,2023-10,244,82,112,50,243,1
11238,2023-11,241,69,121,51,238,3
11238,2023-12,220,79,101,40,217,3
11238,2024-01,207,57,103,47,203,4
11238,2024-02,244,77,115,52,239,5
11238,2024-03,204,60,101,43,203,1
11238,2024-04,225,62,108,55,220,5
11238,2024-05,268,81,131,56,265,3
11238,2024-06,213,51,104,58,211,2
11238,2024-07,235,92,99,44,233,2
11238,2024-08,243,100,97,46,235,8
11238,2024-09,264,82,136,46,260,4
11238,2024-10,266,93,136,37,262,4
11238,2024-11,235,56,126,53,232,3
11238,2024-12,187,45,95,47,186,1
11239,2020-01,37,20,15,2,34,3
11239,2020-02,36,13,18,5,35,1
11239,2020-03,40,17,17,6,39,1
11239,2020-04,30,13,10,7,29,1
11239,2020-05,32,9,16,7,31,1
11239,2020-06,41,13,21,7,39,2
11239,2020-07,47,18,23,6,46,1
11239,2020-08,31,14,14,3,31,0
11239,2020-09,42,15,20,7,41,1
11239,2020-10,45,15,25,5,45,0
11239,2020-11,43,18,18,7,41,2
11239,2020-12,37,11,18,8,37,0
11239,2021-01,49,20,19,10,47,2
11239,2021-02,32,14,15,3,29,2
11239,2021-03,37,14,17,6,36,0
11239,2021-04,28,14,7,7,26,2
11239,2021-05,28,11,10,7,28,0
11239,2021-06,28,12,8,8,28,0
11239,2021-07,38,15,20,3,37,1
11239,2021-08,30,7,21,2,29,1
11239,2021-09,51,20,24,7,49,2
11239,2021-10,47,18,26,3,47,0
11239,2021-11,44,16,18,10,43,1
11239,2021-12,38,11,21,6,37,1
11239,2022-01,37,12,18,7,37,0
11239,2022-02,36,12,19,5,34,2
11239,2022-03,47,15,26,6,46,1
11239,2022-04,49,13,28,8,49,0
11239,2022-05,48,15,28,5,48,0
11239,2022-06,45,16,25,4,45,0
11239,2022-07,41,15,16,10,41,0
11239,2022-08,44,17,20,7,44,0
11239,2022-09,38,16,13,9,38,0
11239,2022-10,79,26,43,10,79,0
11239,2022-11,70,29,28,13,69,1
11239,2022-12,32,11,18,3,31,1
11239,2023-01,42,14,16,12,42,0
11239,2023-02,39,17,15,7,39,0
11239,2023-03,49,23,20,6,49,0
11239,2023-04,47,15,25,7,46,1
11239,2023-05,52,23,19,10,51,1
11239,2023-06,58,14,31,13,57,1
11239,2023-07,58,24,20,14,57,1
11239,2023-08,33,16,14,3,31,2
11239,2023-09,53,24,14,15,52,1
11239,2023-10,41,13,19,9,40,1
11239,2023-11,36,10,16,10,36,0
11239,2023-12,42,10,21,11,42,0
11239,2024-01,32,10,17,5,32,0
11239,2024-02,23,7,10,6,22,1
11239,2024-03,33,15,8,10,33,0
11239,2024-04,47,20,7,20,45,2
11239,2024-05,38,16,17,5,38,0
11239,2024-06,40,12,21,7,40,0
11239,2024-07,52,22,19,11,51,1
11239,2024-08,33,8,13,12,33,0
11239,2024-09,41,16,17,8,39,2
11239,2024-10,35,15,12,8,35,0
11239,2024-11,31,13,12,6,31,0
11239,2024-12,31,12,14,5,31,0
11354,2020-01,258,74,154,30,250,8
11354,2020-02,256,71,146,39,251,5
11354,2020-03,218,72,108,38,216,2
11354,2020-04,140,48,65,27,135,5
11354,2020-05,197,69,93,35,193,4
11354,2020-06,190,76,82,32,188,2
11354,2020-07,233,77,123,33,226,7
11354,2020-08,256,94,125,37,253,3
11354,2020-09,281,106,127,48,272,9
11354,2020-10,261,78,148,35,260,1
11354,2020-11,224,76,113,35,220,4
11354,2020-12,225,73,133,19,219,6
11354,2021-01,196,75,98,23,193,3
11354,2021-02,192,61,102,29,192,0
11354,2021-03,224,70,120,34,220,2
11354,2021-04,174,48,94,32,173,1
11354,2021-05,221,67,126,28,218,3
11354,2021-06,235,70,124,41,233,2
11354,2021-07,260,69,151,40,259,1
11354,2021-08,266,63,159,44,260,6
11354,2021-09,275,67,170,38,270,5
11354,2021-10,330,98,194,38,327,3
11354,2021-11,359,144,178,37,355,4
11354,2021-12,377,143,203,31,372,5
11354,2022-01,278,92,167,19,273,5
11354,2022-02,279,99,154,26,276,3
11354,2022-03,280,93,146,41,280,0
11354,2022-04,336,106,196,34,333,3
11354,2022-05,334,97,196,41,330,4
11354,2022-06,349,122,187,40,341,8
11354,2022-07,315,105,169,41,308,7
11354,2022-08,386,147,191,48,381,5
11354,2022-09,425,165,232,28,418,7
11354,2022-10,389,141,202,46,385,4
11354,2022-11,431,154,236,41,422,9
11354,2022-12,353,143,181,29,350,3
11354,2023-01,401,125,253,23,400,1
11354,2023-02,354,130,186,38,349,5
11354,2023-03,434,155,227,52,428,6
11354,2023-04,345,119,191,35,336,9
11354,2023-05,421,142,243,36,420,1
11354,2023-06,357,120,193,44,356,1
11354,2023-07,417,117,256,44,413,4
11354,2023-08,423,135,250,38,420,3
11354,2023-09,349,116,203,30,342,7
11354,2023-10,405,137,225,43,400,5
11354,2023-11,397,131,213,53,393,4
11354,2023-12,395,131,230,34,390,5
11354,2024-01,374,122,209,43,369,5
11354,2024-02,365,120,200,45,358,7
11354,2024-03,387,119,233,35,378,9
11354,2024-04,381,126,216,39,377,4
11354,2024-05,408,140,215,53,400,8
11354,2024-06,400,141,214,45,395,5
11354,2024-07,413,144,232,37,409,4
11354,2024-08,382,130,210,42,377,5
11354,2024-09,385,129,213,43,384,1
11354,2024-10,399,101,258,40,396,3
11354,2024-11,397,123,236,38,393,4
11354,2024-12,364,76,230,58,364,0
11355,2020-01,192,78,80,34,192,0
11355,2020-02,187,67,96,24,185,2
11355,2020-03,160,57,78,25,160,0
11355,2020-04,136,45,62,29,132,4
11355,2020-05,183,72,81,30,181,2
11355,2020-06,162,53,75,34,162,0
11355,2020-07,205,70,99,36,203,2
11355,2020-08,221,82,101,38,217,4
11355,2020-09,195,84,75,36,192,3
11355,2020-10,200,87,88,25,199,1
11355,2020-11,181,76,76,29,176,5
11355,2020-12,172,66,86,20,171,1
11355,2021-01,133,57,53,23,131,2
11355,2021-02,101,43,46,12,101,0
11355,2021-03,149,44,69,36,147,2
11355,2021-04,138,57,59,22,135,3
11355,2021-05,193,62,92,39,192,1
11355,2021-06,180,45,85,50,179,1
11355,2021-07,166,48,80,38,164,2
11355,2021-08,185,57,95,33,183,2
11355,2021-09,186,68,82,36,185,1
11355,2021-10,171,52,78,41,170,1
11355,2021-11,415,293,94,28,412,3
11355,2021-12,307,181,95,31,307,0
11355,2022-01,230,99,100,31,225,5
11355,2022-02,197,62,106,29,192,5
11355,2022-03,214,85,98,31,212,2
11355,2022-04,217,116,79,22,209,8
11355,2022-05,249,98,112,39,245,4
11355,2022-06,218,98,88,32,217,1
11355,2022-07,243,106,105,32,239,4
11355,2022-08,217,92,89,36,211,6
11355,2022-09,247,110,94,43,243,4
11355,2022-10,220,88,93,39,212,8
11355,2022-11,253,107,112,34,247,6
11355,2022-12,236,103,99,34,233,3
11355,2023-01,304,135,124,45,300,4
11355,2023-02,264,127,105,32,257,7
11355,2023-03,250,108,107,35,246,4
11355,2023-04,245,97,103,45,242,3
11355,2023-05,272,124,105,43,268,4
11355,2023-06,225,102,103,20,220,5
11355,2023-07,227,89,103,35,225,2
11355,2023-08,260,93,129,38,258,2
11355,2023-09,216,75,110,31,215,1
11355,2023-10,258,99,111,48,256,2
11355,2023-11,239,94,95,50,236,3
11355,2023-12,217,88,97,32,214,3
11355,2024-01,232,108,87,37,228,4
11355,2024-02,214,91,101,22,211,3
11355,2024-03,215,86,101,28,212,3
11355,2024-04,229,109,84,36,227,2
11355,2024-05,260,105,114,41,255,5
11355,2024-06,220,91,93,36,216,4
11355,2024-07,250,99,117,34,247,3
11355,2024-08,218,83,94,41,216,2
11355,2024-09,225,104,94,27,223,2
11355,2024-10,211,73,108,30,206,5
11355,2024-11,231,84,106,41,230,1
11355,2024-12,180,71,84,25,180,0
11356,2020-01,89,29,36,24,86,3
11356,2020-02,90,19,37,34,90,0
11356,2020-03,85,21,37,27,84,1
11356,2020-04,75,19,29,27,74,1
11356,2020-05,86,22,50,14,85,1
11356,2020-06,74,23,31,20,73,1
11356,2020-07,89,25,34,30,88,1
11356,2020-08,98,32,49,17,97,1
11356,2020-09,90,27,45,18,90,0
11356,2020-10,93,30,46,17,92,1
11356,2020-11,80,24,45,11,80,0
11356,2020-12,101,24,62,15,100,1
11356,2021-01,74,24,38,12,73,1
11356,2021-02,63,12,38,13,63,0
11356,2021-03,78,23,44,11,77,1
11356,2021-04,92,30,48,14,91,1
11356,2021-05,115,47,47,21,113,2
11356,2021-06,99,20,67,12,99,0
11356,2021-07,134,22,96,16,133,1
11356,2021-08,128,25,91,12,127,1
11356,2021-09,116,27,74,15,116,0
11356,2021-10,106,20,72,14,105,1
11356,2021-11,121,50,58,13,119,2
11356,2021-12,117,29,66,22,117,0
11356,2022-01,128,38,71,19,128,0
11356,2022-02,120,28,71,21,118,2
11356,2022-03,139,33,90,16,138,1
11356,2022-04,147,35,94,18,146,1
11356,2022-05,115,31,60,24,115,0
11356,2022-06,120,36,67,17,119,1
11356,2022-07,133,33,85,15,132,1
11356,2022-08,115,38,52,25,114,1
11356,2022-09,96,36,37,23,93,3
11356,2022-10,136,53,60,23,129,7
11356,2022-11,92,29,47,16,89,3
11356,2022-12,90,34,42,14,87,3
11356,2023-01,120,39,62,19,119,1
11356,2023-02,87,29,39,19,87,0
11356,2023-03,110,39,51,20,108,2
11356,2023-04,127,43,59,25,126,1
11356,2023-05,114,28,67,19,112,2
11356,2023-06,109,39,54,16,106,3
11356,2023-07,142,57,72,13,140,2
11356,2023-08,142,55,68,19,139,3
11356,2023-09,125,43,65,17,123,2
11356,2023-10,130,41,71,18,129,1
11356,2023-11,114,32,64,18,113,1
11356,2023-12,136,45,77,14,135,1
11356,2024-01,141,36,78,27,141,0
11356,2024-02,97,29,50,18,96,1
11356,2024-03,102,27,55,20,101,1
11356,2024-04,104,35,51,18,103,1
11356,2024-05,127,39,66,22,126,1
11356,2024-06,139,32,80,27,138,1
11356,2024-07,134,36,81,17,134,0
11356,2024-08,144,44,73,27,143,1
11356,2024-09,115,26,68,21,113,2
11356,2024-10,124,29,75,20,123,1
11356,2024-11,112,25,57,30,112,0
11356,2024-12,96,22,59,15,96,0
11357,2020-01,69,26,26,17,68,1
11357,2020-02,59,17,35,7,55,4
11357,2020-03,61,23,30,8,59,2
11357,2020-04,50,18,17,15,50,0
11357,2020-05,72,30,28,14,70,2
11357,2020-06,60,17,28,15,59,1
11357,2020-07,94,34,37,23,94,0
11357,2020-08,110,54,36,20,104,6
11357,2020-09,58,23,26,9,57,1
11357,2020-10,65,22,31,12,63,2
11357,2020-11,77,28,38,11,75,2
11357,2020-12,48,18,20,10,47,1
11357,2021-01,76,28,32,16,72,4
11357,2021-02,53,17,15,21,53,0
11357,2021-03,80,33,28,19,78,1
11357,2021-04,63,26,19,18,62,1
11357,2021-05,49,18,18,13,48,1
11357,2021-06,60,18,26,16,57,3
11357,2021-07,74,27,33,14,74,0
11357,2021-08,76,21,34,21,75,1
11357,2021-09,68,17,36,15,68,0
11357,2021-10,76,23,37,16,74,2
11357,2021-11,91,25,47,19,87,4
11357,2021-12,101,36,47,18,101,0
11357,2022-01,96,38,42,16,91,5
11357,2022-02,96,34,53,9,92,4
11357,2022-03,107,28,54,25,107,0
11357,2022-04,100,32,54,14,100,0
11357,2022-05,89,41,34,14,85,4
11357,2022-06,115,33,62,20,115,0
11357,2022-07,94,32,38,24,90,4
11357,2022-08,86,32,38,16,86,0
11357,2022-09,94,40,45,9,93,1
11357,2022-10,89,42,38,9,85,4
11357,2022-11,92,43,38,11,90,2
11357,2022-12,100,44,46,10,95,5
11357,2023-01,84,40,28,16,83,1
11357,2023-02,77,36,30,11,71,6
11357,2023-03,126,53,48,25,122,4
11357,2023-04,72,31,31,10,71,1
11357,2023-05,102,42,47,13,101,1
11357,2023-06,88,40,35,13,82,6
11357,2023-07,83,32,39,12,81,2
11357,2023-08,96,36,46,14,94,2
11357,2023-09,77,28,35,14,76,1
11357,2023-10,105,49,44,12,104,1
11357,2023-11,78,40,27,11,75,3
11357,2023-12,92,36,47,9,91,1
11357,2024-01,112,50,50,12,108,4
11357,2024-02,87,27,42,18,83,4
11357,2024-03,85,32,36,17,85,0
11357,2024-04,82,41,25,16,81,1
11357,2024-05,92,47,34,11,92,0
11357,2024-06,95,39,43,13,93,2
11357,2024-07,92,43,36,13,88,4
11357,2024-08,123,55,55,13,118,5
11357,2024-09,81,30,35,16,79,2
11357,2024-10,104,44,46,14,104,0
11357,2024-11,92,43,33,16,91,1
11357,2024-12,84,28,35,21,81,3
11358,2020-01,54,18,25,11,54,0
11358,2020-02,55,24,24,7,53,2
11358,2020-03,52,24,18,10,50,2
11358,2020-04,52,18,26,8,50,2
11358,2020-05,67,17,33,17,67,0
11358,2020-06,61,24,28,9,59,2
11358,2020-07,62,22,30,10,61,1
11358,2020-08,78,32,34,12,74,4
11358,2020-09,60,20,27,13,56,4
11358,2020-10,68,34,21,13,66,2
11358,2020-11,82,37,30,15,79,3
11358,2020-12,57,19,25,13,56,1
11358,2021-01,58,20,26,12,57,1
11358,2021-02,62,25,28,9,62,0
11358,2021-03,81,34,37,10,78,3
11358,2021-04,71,27,32,12,69,1
11358,2021-05,58,22,22,14,57,1
11358,2021-06,77,26,36,15,75,2
11358,2021-07,85,34,44,7,84,1
11358,2021-08,83,21,39,23,82,1
11358,2021-09,80,26,41,13,79,1
11358,2021-10,78,29,35,14,75,3
11358,2021-11,76,42,27,7,74,2
11358,2021-12,84,35,38,11,80,4
11358,2022-01,100,48,33,19,98,2
11358,2022-02,100,40,45,15,98,2
11358,2022-03,81,34,32,15,81,0
11358,2022-04,91,33,40,18,90,1
11358,2022-05,88,39,39,10,83,5
11358,2022-06,100,43,43,14,96,4
11358,2022-07,90,42,36,12,84,6
11358,2022-08,100,43,42,15,99,1
11358,2022-09,73,33,27,13,67,6
11358,2022-10,91,39,36,16,88,3
11358,2022-11,114,61,32,21,109,5
11358,2022-12,82,34,37,11,79,3
11358,2023-01,101,43,42,16,98,3
11358,2023-02,103,46,40,17,101,2
11358,2023-03,100,41,44,15,98,2
11358,2023-04,105,52,36,17,105,0
11358,2023-05,97,45,34,18,95,2
11358,2023-06,87,35,32,20,84,3
11358,2023-07,89,29,41,19,88,1
11358,2023-08,87,41,32,14,85,2
11358,2023-09,96,36,39,21,90,6
11358,2023-10,83,33,28,22,81,2
11358,2023-11,85,35,34,16,84,1
11358,2023-12,74,28,30,16,73,1
11358,2024-01,79,35,31,13,77,2
11358,2024-02,80,35,34,11,79,1
11358,2024-03,73,34,20,19,69,4
11358,2024-04,92,46,30,16,86,6
11358,2024-05,114,42,47,25,111,3
11358,2024-06,91,38,40,13,87,4
11358,2024-07,114,45,49,20,114,0
11358,2024-08,86,42,25,19,85,1
11358,2024-09,88,38,31,19,85,3
11358,2024-10,112,41,50,21,109,3
11358,2024-11,78,32,34,12,77,1
11358,2024-12,76,38,26,12,74,2
11360,2020-01,29,11,8,10,29,0
11360,2020-02,24,9,8,7,24,0
11360,2020-03,23,12,7,4,22,1
11360,2020-04,16,5,6,5,16,0
11360,2020-05,18,5,7,6,17,1
11360,2020-06,27,9,12,6,27,0
11360,2020-07,34,8,17,9,34,0
11360,2020-08,28,11,6,11,27,1
11360,2020-09,20,8,7,5,20,0
11360,2020-10,27,6,16,5,26,1
11360,2020-11,34,16,14,4,31,3
11360,2020-12,27,16,8,3,25,2
11360,2021-01,17,6,6,5,15,2
11360,2021-02,19,6,8,5,19,0
11360,2021-03,27,8,14,5,26,1
11360,2021-04,34,8,16,10,33,1
11360,2021-05,27,8,12,7,27,0
11360,2021-06,25,12,5,8,24,1
11360,2021-07,33,14,14,5,33,0
11360,2021-08,27,12,7,8,27,0
11360,2021-09,27,10,15,2,27,0
11360,2021-10,20,10,7,3,19,1
11360,2021-11,34,17,12,5,31,3
11360,2021-12,28,12,15,1,27,1
11360,2022-01,40,19,17,4,38,2
11360,2022-02,32,13,14,5,31,1
11360,2022-03,32,16,11,5,30,2
11360,2022-04,26,13,10,3,23,3
11360,2022-05,34,8,21,5,34,0
11360,2022-06,25,9,10,6,24,1
11360,2022-07,28,15,9,4,25,3
11360,2022-08,47,20,15,12,47,0
11360,2022-09,28,11,13,4,27,1
11360,2022-10,32,15,13,4,31,1
11360,2022-11,51,27,17,7,49,2
11360,2022-12,42,23,14,5,38,4
11360,2023-01,29,15,4,10,28,1
11360,2023-02,38,13,17,8,35,3
11360,2023-03,47,27,16,4,47,0
11360,2023-04,38,14,21,3,38,0
11360,2023-05,22,5,9,8,22,0
11360,2023-06,30,9,14,7,30,0
11360,2023-07,39,15,18,6,38,1
11360,2023-08,41,20,18,3,41,0
11360,2023-09,36,22,9,5,34,2
11360,2023-10,37,20,11,6,36,1
11360,2023-11,40,20,11,9,38,2
11360,2023-12,44,15,21,8,44,0
11360,2024-01,29,16,9,4,28,1
11360,2024-02,29,13,13,3,29,0
11360,2024-03,52,29,12,11,52,0
11360,2024-04,40,17,21,2,37,3
11360,2024-05,51,19,26,6,50,1
11360,2024-06,39,15,15,9,39,0
11360,2024-07,34,16,11,7,31,3
11360,2024-08,35,14,10,11,34,1
11360,2024-09,36,13,17,6,36,0
11360,2024-10,36,14,15,7,36,0
11360,2024-11,26,8,10,8,25,1
11360,2024-12,28,19,6,3,28,0
11361,2020-01,77,26,39,12,74,3
11361,2020-02,78,29,37,12,76,2
11361,2020-03,54,19,26,9,50,4
11361,2020-04,26,13,11,2,24,2
11361,2020-05,48,14,25,9,47,1
11361,2020-06,57,13,31,13,54,3
11361,2020-07,79,23,37,19,75,4
11361,2020-08,81,29,42,10,77,4
11361,2020-09,60,23,24,13,59,1
11361,2020-10,75,33,29,13,75,0
11361,2020-11,68,40,19,9,65,3
11361,2020-12,73,29,33,11,67,6
11361,2021-01,71,29,30,12,69,2
11361,2021-02,62,17,34,11,60,2
11361,2021-03,70,24,37,9,68,2
11361,2021-04,76,28,30,18,74,2
11361,2021-05,67,27,26,14,62,5
11361,2021-06,76,31,35,10,76,0
11361,2021-07,85,32,42,11,81,4
11361,2021-08,71,30,35,6,70,1
11361,2021-09,69,26,32,11,66,3
11361,2021-10,66,32,23,11,63,3
11361,2021-11,88,35,44,9,84,4
11361,2021-12,93,36,39,18,92,1
11361,2022-01,88,41,36,11,86,2
11361,2022-02,68,31,31,6,66,2
11361,2022-03,89,46,31,12,86,3
11361,2022-04,86,41,36,9,79,7
11361,2022-05,87,33,41,13,81,6
11361,2022-06,110,45,50,15,104,6
11361,2022-07,112,55,35,22,111,1
11361,2022-08,103,51,40,12,100,3
11361,2022-09,84,30,40,14,82,2
11361,2022-10,117,51,53,13,112,5
11361,2022-11,119,50,54,15,112,7
11361,2022-12,104,52,42,10,103,1
11361,2023-01,125,58,51,16,120,5
11361,2023-02,100,43,39,18,99,1
11361,2023-03,106,49,44,13,103,3
11361,2023-04,90,43,36,11,89,1
11361,2023-05,123,46,54,23,122,1
11361,2023-06,108,46,48,14,104,4
11361,2023-07,104,44,47,13,99,5
11361,2023-08,109,45,51,13,107,2
11361,2023-09,85,34,36,15,83,2
11361,2023-10,96,31,49,16,93,3
11361,2023-11,109,47,47,15,105,4
11361,2023-12,85,37,32,16,80,5
11361,2024-01,88,39,38,11,86,2
11361,2024-02,97,30,50,17,96,1
11361,2024-03,116,59,38,19,112,4
11361,2024-04,125,54,48,23,124,1
11361,2024-05,82,21,51,10,81,1
11361,2024-06,116,40,51,25,110,6
11361,2024-07,99,37,37,25,98,1
11361,2024-08,83,34,34,15,80,3
11361,2024-09,102,29,48,25,99,3
11361,2024-10,102,38,44,20,98,4
11361,2024-11,94,36,36,22,90,4
11361,2024-12,72,27,33,12,69,3
11362,2020-01,27,9,13,5,25,2
11362,2020-02,39,19,14,6,37,2
11362,2020-03,28,9,10,9,27,1
11362,2020-04,25,6,7,12,25,0
11362,2020-05,32,14,13,5,30,2
11362,2020-06,19,5,7,7,19,0
11362,2020-07,37,12,19,6,35,2
11362,2020-08,39,18,15,6,37,2
11362,2020-09,26,11,14,1,25,1
11362,2020-10,23,5,14,4,22,1
11362,2020-11,34,16,14,4,33,1
11362,2020-12,44,18,24,2,41,3
11362,2021-01,16,8,6,2,16,0
11362,2021-02,24,7,12,5,24,0
11362,2021-03,40,11,19,10,40,0
11362,2021-04,33,13,15,5,33,0
11362,2021-05,27,7,15,5,27,0
11362,2021-06,44,23,17,4,41,3
11362,2021-07,32,12,15,5,31,1
11362,2021-08,42,19,11,12,42,0
11362,2021-09,36,13,12,11,36,0
11362,2021-10,41,14,16,11,41,0
11362,2021-11,43,17,16,10,43,0
11362,2021-12,50,15,30,5,47,3
11362,2022-01,39,11,20,8,37,2
11362,2022-02,30,14,12,4,30,0
11362,2022-03,27,8,15,4,27,0
11362,2022-04,49,20,24,5,48,1
11362,2022-05,46,21,13,12,46,0
11362,2022-06,43,21,17,5,42,1
11362,2022-07,54,22,26,6,52,2
11362,2022-08,50,26,18,6,49,1
11362,2022-09,44,16,19,9,43,1
11362,2022-10,62,21,34,7,62,0
11362,2022-11,38,19,13,6,37,1
11362,2022-12,56,33,19,4,53,3
11362,2023-01,49,25,20,4,48,1
11362,2023-02,24,9,11,4,23,1
11362,2023-03,46,18,20,8,43,3
11362,2023-04,33,15,14,4,32,1
11362,2023-05,42,9,24,9,41,1
11362,2023-06,43,12,26,5,43,0
11362,2023-07,50,19,22,9,48,2
11362,2023-08,46,23,15,8,42,4
11362,2023-09,40,13,19,8,40,0
11362,2023-10,47,18,22,7,47,0
11362,2023-11,51,25,20,6,46,5
11362,2023-12,50,14,24,12,49,1
11362,2024-01,49,19,25,5,48,1
11362,2024-02,40,15,20,5,36,4
11362,2024-03,35,10,18,7,35,0
11362,2024-04,51,20,24,7,48,3
11362,2024-05,50,20,23,7,50,0
11362,2024-06,43,20,15,8,39,4
11362,2024-07,41,13,23,5,40,1
11362,2024-08,38,18,17,3,36,2
11362,2024-09,46,23,18,5,45,1
11362,2024-10,55,23,25,7,53,2
11362,2024-11,52,17,29,6,50,2
11362,2024-12,32,13,15,4,31,1
11363,2020-01,10,0,9,1,10,0
11363,2020-02,10,3,2,5,9,1
11363,2020-03,9,3,5,1,9,0
11363,2020-04,10,2,6,2,10,0
11363,2020-05,13,2,11,0,13,0
11363,2020-06,13,4,9,0,13,0
11363,2020-07,17,6,8,3,14,3
11363,2020-08,17,3,9,5,16,1
11363,2020-09,12,1,10,1,11,1
11363,2020-10,1,0,0,1,1,0
11363,2020-11,12,2,9,1,10,2
11363,2020-12,10,4,5,1,10,0
11363,2021-01,10,6,3,1,9,1
11363,2021-02,10,0,8,2,10,0
11363,2021-03,16,4,9,3,15,1
11363,2021-04,15,8,4,3,14,1
11363,2021-05,10,5,5,0,10,0
11363,2021-06,13,3,4,6,13,0
11363,2021-07,12,8,3,1,11,1
11363,2021-08,12,4,3,5,12,0
11363,2021-09,15,8,5,2,15,0
11363,2021-10,9,1,5,3,9,0
11363,2021-11,10,4,4,2,9,1
11363,2021-12,16,9,1,6,15,1
11363,2022-01,11,6,4,1,11,0
11363,2022-02,8,2,2,4,8,0
11363,2022-03,16,9,5,2,15,1
11363,2022-04,14,8,4,2,13,1
11363,2022-05,22,4,12,6,18,4
11363,2022-06,18,5,6,7,18,0
11363,2022-07,31,15,8,8,31,0
11363,2022-08,17,7,5,5,17,0
11363,2022-09,12,7,4,1,12,0
11363,2022-10,21,8,11,2,21,0
11363,2022-11,14,7,6,1,14,0
11363,2022-12,13,8,2,3,12,1
11363,2023-01,17,11,5,1,17,0
11363,2023-02,16,6,6,4,15,1
11363,2023-03,16,11,4,1,16,0
11363,2023-04,9,5,4,0,9,0
11363,2023-05,6,2,2,2,6,0
11363,2023-06,16,6,6,4,15,1
11363,2023-07,15,6,5,4,15,0
11363,2023-08,15,7,5,3,14,1
11363,2023-09,15,5,5,5,15,0
11363,2023-10,7,4,2,1,6,1
11363,2023-11,15,8,2,5,15,0
11363,2023-12,14,8,4,2,11,3
11363,2024-01,18,10,6,2,14,4
11363,2024-02,18,4,11,3,18,0
11363,2024-03,15,7,7,1,13,2
11363,2024-04,17,8,4,5,17,0
11363,2024-05,18,6,10,2,17,1
11363,2024-06,9,4,2,3,9,0
11363,2024-07,18,7,8,3,18,0
11363,2024-08,5,2,2,1,5,0
11363,2024-09,15,4,6,5,15,0
11363,2024-10,12,2,3,7,12,0
11363,2024-11,10,4,3,3,10,0
11363,2024-12,9,3,5,1,9,0
11364,2020-01,60,33,15,12,57,3
11364,2020-02,72,37,21,14,71,1
11364,2020-03,62,17,34,11,61,1
11364,2020-04,36,15,14,7,35,1
11364,2020-05,57,23,22,12,56,1
11364,2020-06,54,20,24,10,53,1
11364,2020-07,59,28,22,9,58,1
11364,2020-08,32,13,16,3,31,1
11364,2020-09,50,24,17,9,48,2
11364,2020-10,74,24,38,12,71,3
11364,2020-11,82,32,35,15,79,3
11364,2020-12,57,26,23,8,55,2
11364,2021-01,61,24,24,13,54,7
11364,2021-02,43,12,21,10,42,1
11364,2021-03,67,23,31,13,63,4
11364,2021-04,72,31,29,12,71,1
11364,2021-05,59,22,25,12,58,1
11364,2021-06,67,24,33,10,65,2
11364,2021-07,53,24,25,4,51,2
11364,2021-08,66,32,20,14,65,1
11364,2021-09,73,32,28,13,71,2
11364,2021-10,76,22,33,21,75,1
11364,2021-11,103,51,39,13,98,5
11364,2021-12,108,51,44,13,105,3
11364,2022-01,91,44,31,16,86,5
11364,2022-02,66,29,26,11,63,3
11364,2022-03,80,30,38,12,76,4
11364,2022-04,67,28,29,10,66,1
11364,2022-05,77,26,38,13,68,9
11364,2022-06,86,40,34,12,79,7
11364,2022-07,78,38,29,11,75,3
11364,2022-08,90,46,31,13,86,4
11364,2022-09,86,39,37,10,82,4
11364,2022-10,123,50,59,14,119,4
11364,2022-11,79,48,21,10,75,4
11364,2022-12,89,44,35,10,82,7
11364,2023-01,94,51,32,11,90,4
11364,2023-02,94,51,34,9,92,2
11364,2023-03,60,22,29,9,57,3
11364,2023-04,62,26,24,12,61,1
11364,2023-05,79,31,28,20,76,3
11364,2023-06,86,28,42,16,83,3
11364,2023-07,73,38,30,5,72,1
11364,2023-08,101,46,36,19,96,5
11364,2023-09,83,32,33,18,80,3
11364,2023-10,99,42,40,17,96,3
11364,2023-11,88,47,31,10,82,6
11364,2023-12,86,37,35,14,85,1
11364,2024-01,66,31,20,15,65,1
11364,2024-02,83,43,29,11,78,5
11364,2024-03,63,38,20,5,61,2
11364,2024-04,76,40,20,16,73,3
11364,2024-05,91,43,29,19,87,4
11364,2024-06,65,23,23,19,63,2
11364,2024-07,108,45,39,24,102,6
11364,2024-08,78,39,33,6,74,4
11364,2024-09,96,31,39,26,94,2
11364,2024-10,84,37,36,11,80,4
11364,2024-11,64,23,27,14,64,0
11364,2024-12,60,28,21,11,59,1
11365,2020-01,115,39,59,17,114,1
11365,2020-02,140,50,71,19,138,2
11365,2020-03,114,37,59,18,112,2
11365,2020-04,80,23,43,14,79,1
11365,2020-05,114,32,63,19,112,2
11365,2020-06,105,32,51,22,103,2
11365,2020-07,118,42,60,16,116,2
11365,2020-08,157,49,90,18,154,3
11365,2020-09,133,41,66,26,132,1
11365,2020-10,117,41,63,13,114,3
11365,2020-11,116,35,56,25,113,3
11365,2020-12,128,34,77,17,126,2
11365,2021-01,104,27,54,23,102,2
11365,2021-02,104,32,49,23,100,4
11365,2021-03,135,40,72,23,133,2
11365,2021-04,136,44,70,22,134,1
11365,2021-05,103,27,52,24,102,1
11365,2021-06,133,47,62,24,132,1
11365,2021-07,142,44,69,29,138,4
11365,2021-08,127,38,63,26,125,2
11365,2021-09,119,36,57,26,114,5
11365,2021-10,136,46,62,28,129,7
11365,2021-11,136,47,74,15,132,4
11365,2021-12,143,50,69,24,140,3
11365,2022-01,124,47,55,22,121,3
11365,2022-02,153,62,79,12,150,3
11365,2022-03,129,43,65,21,128,1
11365,2022-04,150,59,60,31,148,2
11365,2022-05,145,39,72,34,143,2
11365,2022-06,159,49,91,19,156,3
11365,2022-07,145,47,72,26,139,6
11365,2022-08,163,49,89,25,160,3
11365,2022-09,154,45,79,30,153,1
11365,2022-10,161,54,77,30,159,2
11365,2022-11,181,69,83,29,175,6
11365,2022-12,167,59,84,24,162,5
11365,2023-01,156,50,80,26,151,5
11365,2023-02,167,63,73,31,164,3
11365,2023-03,170,58,84,28,165,5
11365,2023-04,153,55,78,20,150,3
11365,2023-05,178,58,83,37,176,2
11365,2023-06,153,54,74,25,149,4
11365,2023-07,184,67,79,38,182,2
11365,2023-08,159,45,87,27,159,0
11365,2023-09,148,58,65,25,146,2
11365,2023-10,184,66,95,23,182,2
11365,2023-11,167,59,85,23,162,5
11365,2023-12,139,52,63,24,138,1
11365,2024-01,143,42,74,27,143,0
11365,2024-02,168,62,82,24,163,5
11365,2024-03,160,54,85,21,158,2
11365,2024-04,149,50,70,29,146,3
11365,2024-05,178,51,97,30,176,2
11365,2024-06,189,56,90,43,187,2
11365,2024-07,171,61,80,30,170,1
11365,2024-08,167,60,81,26,166,1
11365,2024-09,171,60,79,32,169,2
11365,2024-10,157,50,85,22,150,7
11365,2024-11,139,42,69,28,139,0
11365,2024-12,107,33,51,23,106,1
11366,2020-01,40,18,13,9,39,1
11366,2020-02,33,12,18,3,33,0
11366,2020-03,32,17,12,3,32,0
11366,2020-04,21,5,13,3,21,0
11366,2020-05,21,5,11,5,21,0
11366,2020-06,33,11,14,8,33,0
11366,2020-07,24,12,10,2,23,1
11366,2020-08,33,9,18,6,33,0
11366,2020-09,34,13,12,9,33,1
11366,2020-10,40,18,13,9,39,1
11366,2020-11,22,8,13,1,22,0
11366,2020-12,39,13,24,2,38,1
11366,2021-01,21,9,10,2,21,0
11366,2021-02,16,5,7,4,16,0
11366,2021-03,29,10,15,4,29,0
11366,2021-04,38,9,20,9,38,0
11366,2021-05,38,18,10,10,37,1
11366,2021-06,25,9,8,8,25,0
11366,2021-07,41,16,22,3,41,0
11366,2021-08,30,9,16,5,29,1
11366,2021-09,34,12,14,8,33,1
11366,2021-10,45,13,20,12,45,0
11366,2021-11,31,10,15,6,31,0
11366,2021-12,36,18,10,8,36,0
11366,2022-01,53,19,25,9,53,0
11366,2022-02,50,15,29,6,49,1
11366,2022-03,46,18,12,16,46,0
11366,2022-04,40,14,22,4,39,1
11366,2022-05,44,17,19,8,44,0
11366,2022-06,34,16,15,3,34,0
11366,2022-07,52,20,26,6,52,0
11366,2022-08,36,12,15,9,36,0
11366,2022-09,52,19,24,9,51,1
11366,2022-10,47,17,24,6,47,0
11366,2022-11,24,11,11,2,24,0
11366,2022-12,52,16,29,7,51,1
11366,2023-01,43,13,26,4,42,1
11366,2023-02,41,16,17,8,40,1
11366,2023-03,49,8,35,6,49,0
11366,2023-04,35,11,18,6,34,1
11366,2023-05,43,19,18,6,40,3
11366,2023-06,38,15,18,5,37,1
11366,2023-07,40,17,17,6,38,2
11366,2023-08,43,19,20,4,42,1
11366,2023-09,34,15,10,9,33,1
11366,2023-10,39,13,17,9,39,0
11366,2023-11,45,21,18,6,44,1
11366,2023-12,52,21,22,9,49,3
11366,2024-01,27,11,12,4,27,0
11366,2024-02,36,12,18,6,35,1
11366,2024-03,59,21,27,11,58,1
11366,2024-04,48,13,27,8,48,0
11366,2024-05,38,15,17,6,38,0
11366,2024-06,38,19,11,8,37,1
11366,2024-07,35,14,18,3,35,0
11366,2024-08,40,17,17,6,39,1
11366,2024-09,55,17,25,13,53,2
11366,2024-10,33,14,14,5,33,0
11366,2024-11,48,14,25,9,47,1
11366,2024-12,47,17,20,10,47,0
11367,2020-01,97,34,43,20,96,1
11367,2020-02,90,27,47,16,90,0
11367,2020-03,82,23,44,15,81,1
11367,2020-04,97,28,61,8,96,1
11367,2020-05,114,32,71,11,113,1
11367,2020-06,92,23,45,24,91,1
11367,2020-07,104,43,49,12,102,2
11367,2020-08,108,39,55,14,108,0
11367,2020-09,86,31,47,8,86,0
11367,2020-10,88,36,40,12,88,0
11367,2020-11,117,41,52,24,117,0
11367,2020-12,96,31,53,12,96,0
11367,2021-01,107,34,54,19,107,0
11367,2021-02,70,21,33,16,70,0
11367,2021-03,94,26,35,33,94,0
11367,2021-04,86,27,43,16,86,0
11367,2021-05,94,26,51,17,92,2
11367,2021-06,98,27,50,21,97,1
11367,2021-07,113,40,57,16,110,3
11367,2021-08,126,29,69,28,124,2
11367,2021-09,126,37,62,27,125,1
11367,2021-10,119,33,63,23,116,3
11367,2021-11,131,45,67,19,130,1
11367,2021-12,124,44,62,18,122,2
11367,2022-01,142,44,69,29,141,1
11367,2022-02,123,37,59,27,123,0
11367,2022-03,136,37,78,21,133,3
11367,2022-04,123,36,70,17,121,2
11367,2022-05,185,51,100,34,184,1
11367,2022-06,136,46,69,21,134,2
11367,2022-07,137,38,83,16,134,3
11367,2022-08,116,37,56,23,111,5
11367,2022-09,155,51,69,35,152,3
11367,2022-10,167,54,88,25,166,1
11367,2022-11,160,48,81,31,157,3
11367,2022-12,163,48,84,31,162,1
11367,2023-01,118,30,60,28,115,3
11367,2023-02,121,36,64,21,118,3
11367,2023-03,136,37,67,32,136,0
11367,2023-04,127,45,58,24,126,1
11367,2023-05,167,54,81,32,164,3
11367,2023-06,174,64,84,26,172,2
11367,2023-07,135,44,59,32,134,1
11367,2023-08,176,63,92,21,174,2
11367,2023-09,108,30,62,16,107,1
11367,2023-10,147,46,79,22,145,2
11367,2023-11,131,47,64,20,129,2
11367,2023-12,135,41,69,25,135,0
11367,2024-01,110,44,52,14,110,0
11367,2024-02,112,33,62,17,112,0
11367,2024-03,125,40,63,22,122,3
11367,2024-04,119,40,60,19,116,3
11367,2024-05,165,50,88,27,162,3
11367,2024-06,135,49,66,20,133,2
11367,2024-07,128,47,53,28,126,2
11367,2024-08,113,45,53,15,113,0
11367,2024-09,141,41,67,33,139,2
11367,2024-10,137,42,70,25,137,0
11367,2024-11,134,44,62,28,134,0
11367,2024-12,93,35,39,19,90,3
11368,2020-01,336,101,181,54,333,3
11368,2020-02,339,109,169,61,334,5
11368,2020-03,289,95,151,43,285,4
11368,2020-04,234,80,122,32,229,5
11368,2020-05,360,124,174,62,354,6
11368,2020-06,360,97,199,64,359,1
11368,2020-07,391,116,204,71,383,8
11368,2020-08,360,123,172,65,355,5
11368,2020-09,315,98,157,60,309,6
11368,2020-10,365,124,170,71,361,4
11368,2020-11,294,95,143,56,289,5
11368,2020-12,314,99,152,63,312,2
11368,2021-01,324,100,153,71,321,3
11368,2021-02,282,81,157,44,277,5
11368,2021-03,319,81,168,70,314,4
11368,2021-04,318,126,153,39,317,0
11368,2021-05,357,121,175,61,356,1
11368,2021-06,362,124,180,58,362,0
11368,2021-07,418,150,202,66,413,5
11368,2021-08,370,146,170,54,367,3
11368,2021-09,393,153,184,56,391,2
11368,2021-10,432,164,204,64,428,4
11368,2021-11,647,394,184,69,641,6
11368,2021-12,550,327,168,55,546,4
11368,2022-01,424,164,210,50,422,2
11368,2022-02,394,133,200,61,390,4
11368,2022-03,354,109,178,67,351,3
11368,2022-04,393,119,223,51,387,6
11368,2022-05,454,146,240,68,450,4
11368,2022-06,443,179,205,59,436,7
11368,2022-07,433,175,189,69,430,3
11368,2022-08,380,150,183,47,372,8
11368,2022-09,518,252,193,73,511,7
11368,2022-10,416,150,195,71,410,6
11368,2022-11,406,145,196,65,397,9
11368,2022-12,375,134,178,63,370,5
11368,2023-01,433,150,222,61,427,6
11368,2023-02,375,137,196,42,368,7
11368,2023-03,432,155,207,70,425,7
11368,2023-04,435,154,211,70,424,11
11368,2023-05,475,189,234,52,467,8
11368,2023-06,567,254,253,60,561,6
11368,2023-07,542,201,265,76,536,6
11368,2023-08,536,223,258,55,528,8
11368,2023-09,503,192,240,71,495,8
11368,2023-10,470,211,193,66,456,14
11368,2023-11,432,168,201,63,425,7
11368,2023-12,457,199,202,56,454,3
11368,2024-01,433,170,185,78,425,8
11368,2024-02,422,144,223,55,416,6
11368,2024-03,466,193,209,64,460,6
11368,2024-04,437,169,217,51,433,4
11368,2024-05,533,181,287,65,524,9
11368,2024-06,596,237,275,84,587,9
11368,2024-07,599,249,278,72,594,5
11368,2024-08,573,212,307,54,562,11
11368,2024-09,483,192,226,65,479,4
11368,2024-10,510,200,243,67,502,8
11368,2024-11,451,170,233,48,444,7
11368,2024-12,445,183,205,57,438,7
11369,2020-01,224,60,143,21,220,4
11369,2020-02,179,48,109,22,174,5
11369,2020-03,176,56,94,26,175,1
11369,2020-04,136,45,76,15,134,2
11369,2020-05,178,48,101,29,175,3
11369,2020-06,171,42,97,32,169,2
11369,2020-07,197,62,100,35,194,3
11369,2020-08,236,79,121,36,230,6
11369,2020-09,190,49,113,28,187,3
11369,2020-10,208,66,108,34,206,2
11369,2020-11,172,52,98,22,168,4
11369,2020-12,186,49,104,33,185,1
11369,2021-01,175,56,87,32,172,3
11369,2021-02,134,35,82,17,133,1
11369,2021-03,175,40,101,34,175,0
11369,2021-04,179,44,113,22,179,0
11369,2021-05,173,55,99,19,172,1
11369,2021-06,158,39,101,18,156,2
11369,2021-07,190,52,107,31,188,2
11369,2021-08,188,56,99,33,188,0
11369,2021-09,174,52,97,25,172,2
11369,2021-10,173,51,98,24,171,2
11369,2021-11,211,103,85,23,210,1
11369,2021-12,240,101,107,32,238,2
11369,2022-01,185,49,116,20,184,1
11369,2022-02,167,56,91,20,167,0
11369,2022-03,197,59,115,23,196,1
11369,2022-04,185,58,107,20,184,1
11369,2022-05,235,81,120,34,231,4
11369,2022-06,218,56,118,44,216,2
11369,2022-07,230,60,145,25,229,1
11369,2022-08,272,67,172,33,269,3
11369,2022-09,222,54,134,34,221,1
11369,2022-10,257,69,167,21,256,1
11369,2022-11,238,69,150,19,233,5
11369,2022-12,232,66,142,24,229,3
11369,2023-01,242,63,153,26,242,0
11369,2023-02,251,59,168,24,247,4
11369,2023-03,228,74,129,25,227,1
11369,2023-04,243,64,155,24,239,4
11369,2023-05,269,66,169,34,266,3
11369,2023-06,222,54,139,29,221,1
11369,2023-07,280,86,166,28,278,2
11369,2023-08,247,66,146,35,244,3
11369,2023-09,231,83,120,28,226,5
11369,2023-10,269,90,146,33,268,1
11369,2023-11,276,85,160,31,276,0
11369,2023-12,288,85,181,22,286,2
11369,2024-01,254,76,154,24,252,2
11369,2024-02,232,75,136,21,228,4
11369,2024-03,286,84,180,22,285,1
11369,2024-04,256,75,160,21,253,3
11369,2024-05,262,87,144,31,258,4
11369,2024-06,268,89,152,27,264,4
11369,2024-07,338,112,193,33,333,5
11369,2024-08,292,114,149,29,288,4
11369,2024-09,245,80,145,20,242,3
11369,2024-10,241,97,124,20,238,3
11369,2024-11,222,70,123,29,221,1
11369,2024-12,177,63,90,24,176,1
11370,2020-01,65,21,36,8,64,1
11370,2020-02,70,29,27,14,70,0
11370,2020-03,42,20,20,2,41,1
11370,2020-04,52,20,19,13,50,2
11370,2020-05,54,13,32,9,53,1
11370,2020-06,65,20,29,16,64,1
11370,2020-07,75,23,39,13,74,1
11370,2020-08,104,40,45,19,104,0
11370,2020-09,59,27,25,7,57,2
11370,2020-10,96,25,48,23,96,0
11370,2020-11,79,24,38,17,79,0
11370,2020-12,68,17,38,13,68,0
11370,2021-01,62,24,26,12,61,1
11370,2021-02,51,14,28,9,49,2
11370,2021-03,68,18,39,11,68,0
11370,2021-04,64,20,37,7,62,2
11370,2021-05,75,16,43,16,75,0
11370,2021-06,80,28,40,12,80,0
11370,2021-07,85,23,37,25,82,3
11370,2021-08,70,18,30,22,67,3
11370,2021-09,92,24,44,24,92,0
11370,2021-10,80,26,40,14,80,0
11370,2021-11,106,45,44,17,105,1
11370,2021-12,88,37,40,11,88,0
11370,2022-01,98,41,43,14,96,2
11370,2022-02,93,34,49,10,93,0
11370,2022-03,71,32,28,11,70,1
11370,2022-04,81,30,41,10,80,1
11370,2022-05,114,30,75,9,113,1
11370,2022-06,102,33,50,19,102,0
11370,2022-07,101,41,45,15,101,0
11370,2022-08,90,31,46,13,90,0
11370,2022-09,91,41,41,9,89,2
11370,2022-10,89,38,38,13,88,1
11370,2022-11,89,25,53,11,89,0
11370,2022-12,88,38,39,11,88,0
11370,2023-01,71,24,38,9,71,0
11370,2023-02,76,21,43,12,75,1
11370,2023-03,100,33,54,13,100,0
11370,2023-04,83,29,44,10,83,0
11370,2023-05,71,19,42,10,70,1
11370,2023-06,98,43,46,9,98,0
11370,2023-07,90,37,42,11,90,0
11370,2023-08,93,32,44,17,93,0
11370,2023-09,83,29,40,14,83,0
11370,2023-10,87,30,45,12,85,2
11370,2023-11,82,23,46,13,81,1
11370,2023-12,76,32,31,13,76,0
11370,2024-01,79,31,38,10,79,0
11370,2024-02,70,19,40,11,70,0
11370,2024-03,86,25,46,15,86,0
11370,2024-04,84,32,41,11,84,0
11370,2024-05,86,25,51,10,85,1
11370,2024-06,92,37,42,13,91,1
11370,2024-07,114,32,60,22,113,1
11370,2024-08,96,40,40,16,95,1
11370,2024-09,87,33,40,14,87,0
11370,2024-10,134,50,67,17,134,0
11370,2024-11,91,28,53,10,89,2
11370,2024-12,77,30,35,12,75,2
11372,2020-01,219,66,124,29,218,1
11372,2020-02,210,59,110,41,208,2
11372,2020-03,179,52,104,23,179,0
11372,2020-04,153,38,99,16,149,4
11372,2020-05,230,61,142,27,230,0
11372,2020-06,233,71,112,50,230,3
11372,2020-07,247,68,136,43,241,6
11372,2020-08,235,68,127,40,234,1
11372,2020-09,255,79,135,41,251,4
11372,2020-10,244,64,143,37,241,3
11372,2020-11,239,71,126,42,237,2
11372,2020-12,244,66,124,54,243,1
11372,2021-01,236,81,117,38,235,1
11372,2021-02,173,42,109,22,166,7
11372,2021-03,192,57,105,30,190,2
11372,2021-04,279,70,166,43,279,0
11372,2021-05,237,66,138,33,232,5
11372,2021-06,258,85,137,36,257,1
11372,2021-07,268,79,145,44,267,1
11372,2021-08,239,74,117,48,236,3
11372,2021-09,263,90,128,45,262,1
11372,2021-10,326,114,166,46,322,4
11372,2021-11,389,208,131,50,384,5
11372,2021-12,314,143,138,33,312,2
11372,2022-01,263,97,134,32,263,0
11372,2022-02,281,99,147,35,279,2
11372,2022-03,276,86,144,46,275,1
11372,2022-04,306,95,174,37,304,2
11372,2022-05,335,105,182,48,331,4
11372,2022-06,368,120,198,50,364,4
11372,2022-07,325,115,172,38,321,4
11372,2022-08,300,115,152,33,294,6
11372,2022-09,335,122,163,50,331,4
11372,2022-10,328,132,156,40,324,4
11372,2022-11,351,119,186,46,348,3
11372,2022-12,319,103,170,46,319,0
11372,2023-01,328,110,178,40,327,1
11372,2023-02,307,116,147,44,303,4
11372,2023-03,326,92,186,48,323,3
11372,2023-04,259,94,118,47,255,4
11372,2023-05,334,124,172,38,328,6
11372,2023-06,345,130,159,56,339,6
11372,2023-07,362,119,192,51,360,2
11372,2023-08,318,118,153,47,313,5
11372,2023-09,374,137,201,36,371,3
11372,2023-10,398,146,203,49,394,4
11372,2023-11,372,133,188,51,369,3
11372,2023-12,375,138,207,30,370,5
11372,2024-01,469,184,252,33,463,6
11372,2024-02,432,116,273,43,428,4
11372,2024-03,421,124,256,41,416,5
11372,2024-04,404,127,218,59,399,5
11372,2024-05,395,137,199,59,389,6
11372,2024-06,463,163,253,47,456,7
11372,2024-07,459,164,256,39,455,4
11372,2024-08,452,172,240,40,444,8
11372,2024-09,399,141,212,46,394,5
11372,2024-10,404,138,220,46,400,4
11372,2024-11,410,146,236,28,404,6
11372,2024-12,330,115,177,38,326,4
11373,2020-01,376,136,189,51,369,7
11373,2020-02,356,99,217,40,351,5
11373,2020-03,304,91,159,54,295,9
11373,2020-04,169,55,97,17,167,2
11373,2020-05,245,63,136,46,238,7
11373,2020-06,276,91,151,34,271,5
11373,2020-07,319,93,169,57,315,4
11373,2020-08,338,106,174,58,329,9
11373,2020-09,352,122,178,52,349,3
11373,2020-10,373,129,181,63,367,6
11373,2020-11,292,90,162,40,290,2
11373,2020-12,306,99,167,40,301,5
11373,2021-01,280,95,152,33,278,2
11373,2021-02,270,83,146,41,267,3
11373,2021-03,350,90,223,37,348,2
11373,2021-04,351,102,209,40,347,3
11373,2021-05,387,98,215,74,378,9
11373,2021-06,353,110,203,40,350,3
11373,2021-07,400,119,224,57,394,6
11373,2021-08,380,119,222,39,376,4
11373,2021-09,410,126,239,45,407,3
11373,2021-10,468,142,260,66,461,7
11373,2021-11,580,268,255,57,570,10
11373,2021-12,487,213,220,54,478,9
11373,2022-01,467,155,257,55,458,9
11373,2022-02,373,108,222,43,369,4
11373,2022-03,411,127,232,52,408,3
11373,2022-04,420,133,227,60,412,8
11373,2022-05,471,161,255,55,464,7
11373,2022-06,497,159,275,63,492,5
11373,2022-07,482,160,268,54,469,13
11373,2022-08,498,150,292,56,492,6
11373,2022-09,488,175,238,75,479,9
11373,2022-10,495,148,297,50,491,4
11373,2022-11,545,155,334,56,535,10
11373,2022-12,477,144,280,53,470,7
11373,2023-01,540,145,332,63,536,4
11373,2023-02,469,138,287,44,465,4
11373,2023-03,499,157,284,58,492,7
11373,2023-04,477,146,270,61,471,6
11373,2023-05,542,180,295,67,536,6
11373,2023-06,545,173,336,36,536,9
11373,2023-07,551,178,311,62,545,6
11373,2023-08,585,177,353,55,580,5
11373,2023-09,515,172,305,38,508,7
11373,2023-10,579,181,336,62,576,3
11373,2023-11,612,178,382,52,606,6
11373,2023-12,670,188,422,60,662,8
11373,2024-01,664,193,412,59,657,7
11373,2024-02,622,178,404,40,616,6
11373,2024-03,586,172,357,57,578,8
11373,2024-04,610,158,394,58,606,4
11373,2024-05,657,225,373,59,651,6
11373,2024-06,672,205,412,55,658,14
11373,2024-07,685,209,405,71,676,9
11373,2024-08,597,184,362,51,594,3
11373,2024-09,600,176,358,66,589,11
11373,2024-10,610,204,342,64,598,12
11373,2024-11,518,165,297,56,513,5
11373,2024-12,464,128,292,44,459,5
11374,2020-01,130,28,88,14,128,2
11374,2020-02,78,26,41,11,77,1
11374,2020-03,103,24,62,17,101,2
11374,2020-04,71,18,36,17,69,2
11374,2020-05,79,21,47,11,76,3
11374,2020-06,78,21,46,11,76,2
11374,2020-07,105,23,55,27,105,0
11374,2020-08,110,30,56,24,108,2
11374,2020-09,84,27,43,14,82,2
11374,2020-10,101,33,53,15,99,2
11374,2020-11,115,24,72,19,115,0
11374,2020-12,93,24,45,24,93,0
11374,2021-01,92,24,51,17,91,1
11374,2021-02,90,18,56,16,90,0
11374,2021-03,121,25,84,12,120,1
11374,2021-04,107,31,63,13,103,4
11374,2021-05,115,31,62,22,113,2
11374,2021-06,86,19,46,21,86,0
11374,2021-07,118,36,66,16,114,4
11374,2021-08,124,30,76,18,124,0
11374,2021-09,144,31,83,30,144,0
11374,2021-10,131,36,78,17,130,1
11374,2021-11,159,39,108,12,158,1
11374,2021-12,170,61,90,19,169,1
11374,2022-01,130,41,80,9,130,0
11374,2022-02,119,27,79,13,118,1
11374,2022-03,164,43,98,23,159,5
11374,2022-04,164,50,93,21,163,1
11374,2022-05,143,46,75,22,141,2
11374,2022-06,126,32,73,21,125,1
11374,2022-07,169,36,105,28,167,2
11374,2022-08,189,56,101,32,186,3
11374,2022-09,171,52,89,30,169,2
11374,2022-10,168,48,103,17,168,0
11374,2022-11,154,47,93,14,152,2
11374,2022-12,164,45,104,15,163,1
11374,2023-01,166,43,98,25,165,1
11374,2023-02,127,35,75,17,125,2
11374,2023-03,161,41,101,19,158,3
11374,2023-04,149,32,88,29,149,0
11374,2023-05,172,47,99,26,170,2
11374,2023-06,160,43,91,26,159,1
11374,2023-07,149,44,83,22,149,0
11374,2023-08,125,36,70,19,122,3
11374,2023-09,166,36,105,25,165,1
11374,2023-10,161,50,81,30,157,4
11374,2023-11,144,51,75,18,143,1
11374,2023-12,129,36,64,29,127,2
11374,2024-01,115,25,58,32,115,0
11374,2024-02,133,30,74,29,132,1
11374,2024-03,122,36,70,16,119,3
11374,2024-04,143,40,80,23,141,2
11374,2024-05,171,38,104,29,170,1
11374,2024-06,158,35,105,18,157,1
11374,2024-07,151,37,97,17,149,2
11374,2024-08,187,59,104,24,184,3
11374,2024-09,151,46,76,29,144,7
11374,2024-10,141,41,82,18,139,2
11374,2024-11,132,29,86,17,130,2
11374,2024-12,161,37,99,25,160,1
11375,2020-01,143,38,89,16,143,0
11375,2020-02,153,32,97,24,153,0
11375,2020-03,156,51,90,15,154,2
11375,2020-04,128,35,74,19,128,0
11375,2020-05,170,38,112,20,168,2
11375,2020-06,132,35,71,26,130,2
11375,2020-07,171,31,122,18,168,3
11375,2020-08,184,43,129,12,180,4
11375,2020-09,166,44,103,19,164,2
11375,2020-10,173,39,117,17,173,0
11375,2020-11,174,44,114,16,173,1
11375,2020-12,213,55,132,26,208,5
11375,2021-01,235,50,173,12,230,5
11375,2021-02,170,33,118,19,162,8
11375,2021-03,226,34,166,26,221,4
11375,2021-04,168,39,108,21,165,3
11375,2021-05,182,36,124,22,182,0
11375,2021-06,171,41,97,33,168,3
11375,2021-07,199,46,122,31,194,5
11375,2021-08,192,32,129,31,192,0
11375,2021-09,205,46,130,29,201,4
11375,2021-10,239,60,138,41,235,4
11375,2021-11,239,60,151,28,236,3
11375,2021-12,213,60,132,21,209,4
11375,2022-01,195,44,135,16,192,3
11375,2022-02,239,64,151,24,236,3
11375,2022-03,270,70,173,27,270,0
11375,2022-04,214,64,120,30,212,2
11375,2022-05,245,75,121,49,241,4
11375,2022-06,237,49,155,33,236,1
11375,2022-07,226,60,136,30,220,6
11375,2022-08,291,77,175,39,288,3
11375,2022-09,224,52,146,26,223,1
11375,2022-10,206,44,130,32,205,1
11375,2022-11,228,62,140,26,228,0
11375,2022-12,219,58,141,20,215,4
11375,2023-01,240,71,144,25,236,4
11375,2023-02,215,70,124,21,212,3
11375,2023-03,221,74,125,22,218,3
11375,2023-04,212,47,130,35,212,0
11375,2023-05,251,78,141,32,248,3
11375,2023-06,204,68,111,25,204,0
11375,2023-07,221,63,121,37,216,5
11375,2023-08,290,78,171,41,288,2
11375,2023-09,214,55,136,23,213,1
11375,2023-10,252,73,140,39,249,3
11375,2023-11,227,53,147,27,225,2
11375,2023-12,276,70,181,25,274,2
11375,2024-01,242,48,163,31,239,3
11375,2024-02,272,56,173,43,270,2
11375,2024-03,249,62,152,35,244,5
11375,2024-04,222,64,133,25,216,6
11375,2024-05,260,81,139,40,256,4
11375,2024-06,323,84,175,64,320,3
11375,2024-07,248,62,153,33,245,3
11375,2024-08,250,47,172,31,245,5
11375,2024-09,280,66,179,35,275,5
11375,2024-10,298,51,200,47,296,2
11375,2024-11,260,60,170,30,257,3
11375,2024-12,236,56,166,14,230,6
11377,2020-01,201,63,104,34,199,2
11377,2020-02,184,70,78,36,183,1
11377,2020-03,206,77,89,40,205,1
11377,2020-04,190,54,111,25,186,4
11377,2020-05,231,76,100,55,227,4
11377,2020-06,221,60,109,52,221,0
11377,2020-07,224,63,123,38,222,2
11377,2020-08,261,86,122,53,256,5
11377,2020-09,269,112,107,50,265,4
11377,2020-10,221,78,98,45,219,2
11377,2020-11,240,89,115,36,239,1
11377,2020-12,251,102,111,38,246,5
11377,2021-01,210,55,113,42,208,2
11377,2021-02,172,47,90,35,169,3
11377,2021-03,285,97,141,47,284,1
11377,2021-04,255,86,117,52,252,3
11377,2021-05,285,92,147,46,282,3
11377,2021-06,265,72,137,56,262,3
11377,2021-07,316,89,161,66,312,4
11377,2021-08,289,79,155,55,288,1
11377,2021-09,293,95,135,63,291,2
11377,2021-10,329,115,156,58,324,5
11377,2021-11,347,130,160,57,341,6
11377,2021-12,311,126,135,50,310,1
11377,2022-01,272,110,124,38,271,1
11377,2022-02,261,95,118,48,258,3
11377,2022-03,280,96,143,41,280,0
11377,2022-04,294,93,161,40,291,3
11377,2022-05,345,109,175,61,343,2
11377,2022-06,322,111,157,54,317,5
11377,2022-07,277,103,139,35,273,4
11377,2022-08,371,113,199,59,365,6
11377,2022-09,363,135,185,43,357,6
11377,2022-10,377,119,198,60,374,3
11377,2022-11,340,123,163,54,336,4
11377,2022-12,327,114,178,35,324,3
11377,2023-01,333,122,167,44,328,5
11377,2023-02,293,102,146,45,290,3
11377,2023-03,329,126,157,46,325,4
11377,2023-04,317,104,158,55,315,2
11377,2023-05,375,123,167,85,372,3
11377,2023-06,324,108,170,46,320,4
11377,2023-07,321,105,179,37,319,2
11377,2023-08,323,115,168,40,318,5
11377,2023-09,318,113,166,39,309,9
11377,2023-10,345,122,169,54,340,5
11377,2023-11,253,109,109,35,249,4
11377,2023-12,302,105,141,56,301,1
11377,2024-01,272,88,137,47,269,3
11377,2024-02,272,97,143,32,271,1
11377,2024-03,289,94,143,52,281,8
11377,2024-04,292,100,141,51,290,2
11377,2024-05,289,101,129,59,287,2
11377,2024-06,291,113,134,44,289,2
11377,2024-07,291,124,129,38,286,5
11377,2024-08,299,115,136,48,291,8
11377,2024-09,283,116,124,43,278,5
11377,2024-10,258,78,141,39,254,4
11377,2024-11,260,72,130,58,260,0
11377,2024-12,231,85,114,32,226,5
11378,2020-01,128,34,72,22,124,4
11378,2020-02,106,48,45,13,102,4
11378,2020-03,93,38,37,18,88,5
11378,2020-04,69,26,30,13,66,3
11378,2020-05,118,48,56,14,111,7
11378,2020-06,92,36,40,16,90,2
11378,2020-07,99,31,43,25,98,1
11378,2020-08,122,36,55,31,119,3
11378,2020-09,121,50,52,19,113,8
11378,2020-10,121,39,64,18,119,2
11378,2020-11,82,24,42,16,80,2
11378,2020-12,100,31,48,21,100,0
11378,2021-01,120,44,54,22,119,1
11378,2021-02,98,34,51,13,98,0
11378,2021-03,105,27,62,16,102,3
11378,2021-04,99,31,58,10,97,2
11378,2021-05,128,47,66,15,128,0
11378,2021-06,100,32,49,19,99,1
11378,2021-07,124,31,71,22,124,0
11378,2021-08,112,34,54,24,110,2
11378,2021-09,109,35,53,21,108,1
11378,2021-10,101,39,46,16,97,4
11378,2021-11,133,51,65,17,127,6
11378,2021-12,124,56,56,12,121,3
11378,2022-01,123,49,53,21,121,2
11378,2022-02,90,35,41,14,88,2
11378,2022-03,111,29,59,23,108,3
11378,2022-04,118,44,60,14,115,3
11378,2022-05,130,50,58,22,130,0
11378,2022-06,159,58,76,25,153,6
11378,2022-07,136,49,61,26,133,3
11378,2022-08,142,52,65,25,138,4
11378,2022-09,129,48,69,12,125,4
11378,2022-10,134,65,52,17,131,3
11378,2022-11,149,67,62,20,147,2
11378,2022-12,122,56,51,15,119,3
11378,2023-01,143,54,69,20,140,3
11378,2023-02,127,63,51,13,122,5
11378,2023-03,121,50,50,21,119,2
11378,2023-04,108,43,53,12,105,3
11378,2023-05,126,53,52,21,125,1
11378,2023-06,120,51,50,19,119,1
11378,2023-07,137,66,56,15,136,1
11378,2023-08,138,48,66,24,136,2
11378,2023-09,111,48,47,16,108,3
11378,2023-10,118,50,51,17,117,1
11378,2023-11,91,33,47,11,89,2
11378,2023-12,121,49,52,20,121,0
11378,2024-01,124,52,57,15,123,1
11378,2024-02,146,55,76,15,145,1
11378,2024-03,111,42,57,12,110,1
11378,2024-04,120,45,57,18,118,2
11378,2024-05,132,48,65,19,130,2
11378,2024-06,141,55,75,11,139,2
11378,2024-07,143,61,66,16,141,2
11378,2024-08,133,63,51,19,129,4
11378,2024-09,127,52,56,19,124,3
11378,2024-10,124,51,56,17,123,1
11378,2024-11,125,57,53,15,120,5
11378,2024-12,89,31,50,8,88,1
11379,2020-01,117,23,76,18,107,10
11379,2020-02,74,35,25,14,73,1
11379,2020-03,69,23,36,10,67,2
11379,2020-04,61,22,27,12,60,1
11379,2020-05,63,21,29,13,62,1
11379,2020-06,96,25,60,11,91,5
11379,2020-07,103,31,56,16,100,3
11379,2020-08,88,28,42,18,83,5
11379,2020-09,116,38,54,24,113,3
11379,2020-10,97,22,55,20,95,2
11379,2020-11,90,26,50,14,87,3
11379,2020-12,77,27,36,14,73,4
11379,2021-01,83,27,41,15,78,5
11379,2021-02,92,37,46,9,88,4
11379,2021-03,72,16,44,12,71,1
11379,2021-04,71,22,39,10,69,2
11379,2021-05,81,18,42,21,80,1
11379,2021-06,76,27,24,25,75,1
11379,2021-07,76,23,38,15,76,0
11379,2021-08,72,21,41,10,70,2
11379,2021-09,105,31,54,20,102,3
11379,2021-10,99,32,47,20,96,3
11379,2021-11,97,38,46,13,93,4
11379,2021-12,107,39,51,17,103,4
11379,2022-01,94,28,51,15,93,1
11379,2022-02,75,18,41,16,73,2
11379,2022-03,89,25,46,18,88,1
11379,2022-04,107,29,62,16,105,2
11379,2022-05,76,27,32,17,75,1
11379,2022-06,94,35,36,23,93,1
11379,2022-07,93,37,40,16,91,2
11379,2022-08,108,34,62,12,105,3
11379,2022-09,109,48,47,14,106,3
11379,2022-10,73,28,37,8,73,0
11379,2022-11,66,22,36,8,64,2
11379,2022-12,54,19,27,8,52,2
11379,2023-01,78,19,41,18,75,3
11379,2023-02,70,29,31,10,69,1
11379,2023-03,78,35,30,13,77,1
11379,2023-04,89,44,36,9,88,1
11379,2023-05,98,32,53,13,98,0
11379,2023-06,100,32,49,19,97,3
11379,2023-07,79,35,33,11,76,3
11379,2023-08,92,38,40,14,92,0
11379,2023-09,90,36,41,13,87,3
11379,2023-10,73,27,30,16,72,1
11379,2023-11,85,34,41,10,84,1
11379,2023-12,83,40,32,11,80,3
11379,2024-01,76,36,33,7,75,1
11379,2024-02,75,29,36,10,73,2
11379,2024-03,76,34,29,13,72,4
11379,2024-04,97,35,42,20,96,1
11379,2024-05,87,23,50,14,87,0
11379,2024-06,99,38,46,15,97,2
11379,2024-07,100,38,43,19,97,3
11379,2024-08,87,21,50,16,87,0
11379,2024-09,96,36,40,20,95,1
11379,2024-10,75,29,17,29,75,0
11379,2024-11,72,17,38,17,72,0
11379,2024-12,73,17,42,14,72,1
11385,2020-01,388,120,213,55,381,7
11385,2020-02,287,85,164,38,282,5
11385,2020-03,328,100,160,68,324,4
11385,2020-04,224,80,107,37,218,6
11385,2020-05,295,87,162,46,286,9
11385,2020-06,333,93,185,55,320,13
11385,2020-07,376,126,185,65,367,9
11385,2020-08,421,122,229,70,414,7
11385,2020-09,331,106,180,45,324,7
11385,2020-10,400,112,227,61,393,7
11385,2020-11,378,118,206,54,374,4
11385,2020-12,338,123,168,47,331,7
11385,2021-01,347,95,201,51,343,4
11385,2021-02,280,87,151,42,280,0
11385,2021-03,312,95,166,51,309,2
11385,2021-04,275,84,145,46,270,4
11385,2021-05,332,107,172,53,329,3
11385,2021-06,307,75,184,48,303,4
11385,2021-07,354,134,162,58,352,2
11385,2021-08,343,101,186,56,340,3
11385,2021-09,347,130,162,55,334,13
11385,2021-10,352,115,168,69,350,2
11385,2021-11,312,111,165,36,302,10
11385,2021-12,355,127,171,57,349,6
11385,2022-01,316,108,157,51,315,1
11385,2022-02,290,107,133,50,287,3
11385,2022-03,338,110,171,57,332,6
11385,2022-04,337,126,169,42,334,3
11385,2022-05,394,141,199,54,384,10
11385,2022-06,386,137,189,60,375,11
11385,2022-07,394,131,203,60,389,5
11385,2022-08,371,150,168,53,358,13
11385,2022-09,339,128,167,44,332,7
11385,2022-10,380,132,191,57,373,7
11385,2022-11,392,144,206,42,386,6
11385,2022-12,373,131,197,45,366,7
11385,2023-01,331,115,173,43,328,3
11385,2023-02,322,113,173,36,315,7
11385,2023-03,324,93,185,46,320,4
11385,2023-04,332,120,161,51,324,8
11385,2023-05,356,152,154,50,348,8
11385,2023-06,354,132,166,56,348,6
11385,2023-07,364,142,180,42,356,8
11385,2023-08,377,139,187,51,370,7
11385,2023-09,321,131,155,35,310,11
11385,2023-10,415,164,204,47,409,6
11385,2023-11,318,108,164,46,314,4
11385,2023-12,344,135,165,44,336,8
11385,2024-01,367,155,167,45,360,7
11385,2024-02,346,128,183,35,341,5
11385,2024-03,341,115,172,54,335,6
11385,2024-04,339,149,144,46,330,9
11385,2024-05,373,139,192,42,369,4
11385,2024-06,392,154,180,58,388,4
11385,2024-07,367,137,167,63,364,3
11385,2024-08,374,144,172,58,372,2
11385,2024-09,335,116,173,46,328,7
11385,2024-10,356,131,165,60,348,8
11385,2024-11,323,116,157,50,323,0
11385,2024-12,290,94,146,50,284,6
11411,2020-01,68,26,28,14,67,1
11411,2020-02,61,18,29,14,60,1
11411,2020-03,66,19,34,13,64,2
11411,2020-04,52,24,25,3,50,2
11411,2020-05,69,18,38,13,69,0
11411,2020-06,58,19,29,10,58,0
11411,2020-07,56,29,21,6,56,0
11411,2020-08,65,24,21,20,63,2
11411,2020-09,66,27,28,11,64,2
11411,2020-10,60,12,41,7,59,1
11411,2020-11,54,20,25,9,52,2
11411,2020-12,48,17,21,10,48,0
11411,2021-01,65,23,34,8,63,2
11411,2021-02,48,13,25,10,46,2
11411,2021-03,59,22,25,12,59,0
11411,2021-04,45,13,27,5,44,1
11411,2021-05,55,16,30,9,54,1
11411,2021-06,50,20,24,6,48,2
11411,2021-07,62,24,25,13,60,2
11411,2021-08,49,10,20,19,49,0
11411,2021-09,74,23,32,19,72,2
11411,2021-10,64,17,31,16,64,0
11411,2021-11,63,18,36,9,63,0
11411,2021-12,97,29,56,12,95,2
11411,2022-01,65,21,37,7,63,2
11411,2022-02,66,12,43,11,66,0
11411,2022-03,74,20,45,9,73,1
11411,2022-04,54,16,29,9,53,1
11411,2022-05,68,16,39,13,67,1
11411,2022-06,68,25,29,14,68,0
11411,2022-07,74,27,34,13,74,0
11411,2022-08,79,16,42,21,79,0
11411,2022-09,63,13,30,20,63,0
11411,2022-10,79,23,43,13,76,3
11411,2022-11,72,16,39,17,72,0
11411,2022-12,81,22,47,12,80,1
11411,2023-01,83,21,46,16,82,1
11411,2023-02,68,13,41,14,67,1
11411,2023-03,89,23,51,15,87,2
11411,2023-04,100,27,54,19,99,1
11411,2023-05,97,23,45,29,96,1
11411,2023-06,70,23,34,13,70,0
11411,2023-07,87,33,36,18,87,0
11411,2023-08,88,23,44,21,88,0
11411,2023-09,96,27,54,15,96,0
11411,2023-10,61,15,25,21,59,2
11411,2023-11,53,12,27,14,53,0
11411,2023-12,92,20,50,22,89,3
11411,2024-01,72,25,34,13,71,1
11411,2024-02,59,25,20,14,58,1
11411,2024-03,63,14,29,20,63,0
11411,2024-04,67,23,26,18,67,0
11411,2024-05,85,26,40,19,85,0
11411,2024-06,77,18,37,22,77,0
11411,2024-07,65,9,40,16,65,0
11411,2024-08,59,25,21,13,59,0
11411,2024-09,59,16,29,14,59,0
11411,2024-10,69,22,33,14,68,1
11411,2024-11,70,19,42,9,70,0
11411,2024-12,72,16,43,13,71,1
11412,2020-01,144,52,67,25,143,1
11412,2020-02,118,36,53,29,117,1
11412,2020-03,86,33,37,16,86,0
11412,2020-04,103,30,54,19,103,0
11412,2020-05,138,41,70,27,138,0
11412,2020-06,120,42,54,24,119,1
11412,2020-07,147,48,75,24,145,2
11412,2020-08,125,46,51,28,125,0
11412,2020-09,105,45,44,16,104,1
11412,2020-10,118,34,57,27,118,0
11412,2020-11,130,51,54,25,130,0
11412,2020-12,116,33,58,25,114,2
11412,2021-01,126,49,51,26,124,2
11412,2021-02,108,41,46,21,108,0
11412,2021-03,113,36,48,29,112,1
11412,2021-04,101,42,48,11,99,0
11412,2021-05,109,39,39,31,108,1
11412,2021-06,129,44,59,26,127,2
11412,2021-07,128,45,57,26,128,0
11412,2021-08,126,48,53,25,125,1
11412,2021-09,119,47,49,23,117,2
11412,2021-10,141,53,57,31,140,1
11412,2021-11,126,49,52,25,121,5
11412,2021-12,111,45,47,19,109,2
11412,2022-01,121,36,69,16,120,1
11412,2022-02,109,37,49,23,108,1
11412,2022-03,121,42,49,30,120,1
11412,2022-04,126,54,53,19,124,2
11412,2022-05,147,52,71,24,147,0
11412,2022-06,112,33,61,18,112,0
11412,2022-07,128,39,64,25,128,0
11412,2022-08,141,49,62,30,139,2
11412,2022-09,129,41,60,28,128,1
11412,2022-10,147,46,68,33,145,2
11412,2022-11,137,46,69,22,136,1
11412,2022-12,148,51,78,19,147,1
11412,2023-01,148,44,70,34,146,2
11412,2023-02,129,42,65,22,129,0
11412,2023-03,126,32,67,27,125,1
11412,2023-04,125,52,56,17,123,2
11412,2023-05,141,45,66,30,140,1
11412,2023-06,133,35,60,38,133,0
11412,2023-07,150,53,61,36,148,2
11412,2023-08,170,59,78,33,168,2
11412,2023-09,163,54,69,40,162,1
11412,2023-10,131,30,71,30,131,0
11412,2023-11,122,38,61,23,120,2
11412,2023-12,147,44,77,26,145,2
11412,2024-01,151,55,72,24,149,2
11412,2024-02,140,46,71,23,139,1
11412,2024-03,101,36,45,20,100,1
11412,2024-04,120,39,60,21,119,1
11412,2024-05,181,57,88,36,178,3
11412,2024-06,151,51,67,33,151,0
11412,2024-07,161,43,86,32,160,1
11412,2024-08,164,62,77,25,161,3
11412,2024-09,137,47,64,26,134,3
11412,2024-10,145,50,63,32,145,0
11412,2024-11,146,51,67,28,144,2
11412,2024-12,139,53,70,16,136,3
11413,2020-01,160,62,72,26,157,3
11413,2020-02,161,59,69,33,158,3
11413,2020-03,120,38,53,29,118,2
11413,2020-04,105,40,45,20,103,2
11413,2020-05,146,59,58,29,143,3
11413,2020-06,128,43,57,28,127,1
11413,2020-07,175,70,68,37,172,3
11413,2020-08,177,67,66,44,171,6
11413,2020-09,166,63,64,39,165,1
11413,2020-10,164,58,76,30,160,4
11413,2020-11,122,40,51,31,119,3
11413,2020-12,159,75,63,21,157,2
11413,2021-01,161,65,60,36,157,4
11413,2021-02,108,41,40,27,107,1
11413,2021-03,129,52,58,19,128,1
11413,2021-04,111,40,46,25,110,1
11413,2021-05,171,74,74,23,170,1
11413,2021-06,138,52,52,34,135,3
11413,2021-07,148,57,62,29,146,2
11413,2021-08,152,62,62,28,150,2
11413,2021-09,173,66,66,41,170,3
11413,2021-10,151,59,60,32,151,0
11413,2021-11,151,53,69,29,151,0
11413,2021-12,160,69,61,30,159,1
11413,2022-01,164,61,79,24,160,4
11413,2022-02,106,36,56,14,105,1
11413,2022-03,155,54,74,27,153,2
11413,2022-04,147,49,69,29,147,0
11413,2022-05,161,49,74,38,158,3
11413,2022-06,172,61,78,33,170,2
11413,2022-07,197,57,92,48,197,0
11413,2022-08,182,70,79,33,178,4
11413,2022-09,176,80,68,28,176,0
11413,2022-10,181,55,98,28,177,4
11413,2022-11,161,61,74,26,161,0
11413,2022-12,178,58,90,30,177,1
11413,2023-01,170,46,97,27,170,0
11413,2023-02,184,47,104,33,182,2
11413,2023-03,203,61,117,25,198,5
11413,2023-04,178,51,90,37,175,3
11413,2023-05,229,87,103,39,228,1
11413,2023-06,181,49,94,38,178,3
11413,2023-07,183,43,108,32,182,1
11413,2023-08,176,65,84,27,174,2
11413,2023-09,160,57,74,29,160,0
11413,2023-10,178,53,93,32,177,1
11413,2023-11,199,61,111,27,196,3
11413,2023-12,171,60,84,27,168,3
11413,2024-01,172,58,78,36,169,3
11413,2024-02,168,68,73,27,165,3
11413,2024-03,162,46,81,35,160,2
11413,2024-04,161,54,76,31,157,4
11413,2024-05,203,76,90,37,199,4
11413,2024-06,181,65,81,35,179,2
11413,2024-07,170,48,90,32,169,1
11413,2024-08,156,53,66,37,154,2
11413,2024-09,177,64,77,36,177,0
11413,2024-10,185,54,91,40,184,1
11413,2024-11,182,49,87,46,180,2
11413,2024-12,199,65,101,33,199,0
11414,2020-01,79,29,35,15,78,1
11414,2020-02,86,34,39,13,84,2
11414,2020-03,63,28,27,8,62,1
11414,2020-04,39,16,15,8,39,0
11414,2020-05,74,31,27,16,74,0
11414,2020-06,80,35,35,10,76,4
11414,2020-07,80,33,38,9,78,2
11414,2020-08,84,25,41,18,84,0
11414,2020-09,81,25,38,18,80,1
11414,2020-10,83,35,37,11,82,1
11414,2020-11,85,39,26,20,82,3
11414,2020-12,54,18,23,13,54,0
11414,2021-01,58,18,30,10,58,0
11414,2021-02,55,21,22,12,54,1
11414,2021-03,74,34,32,8,74,0
11414,2021-04,68,29,27,12,67,1
11414,2021-05,73,20,41,12,72,1
11414,2021-06,80,23,37,20,78,2
11414,2021-07,74,28,31,15,74,0
11414,2021-08,65,21,32,12,65,0
11414,2021-09,98,32,49,17,96,2
11414,2021-10,103,45,40,18,101,2
11414,2021-11,78,26,41,11,77,1
11414,2021-12,84,32,37,15,83,1
11414,2022-01,59,26,21,12,59,0
11414,2022-02,76,35,31,10,74,2
11414,2022-03,94,31,47,16,94,0
11414,2022-04,92,38,36,18,89,3
11414,2022-05,71,26,33,12,70,1
11414,2022-06,100,37,43,20,98,2
11414,2022-07,84,25,40,19,83,1
11414,2022-08,101,31,50,20,98,3
11414,2022-09,88,39,35,14,87,1
11414,2022-10,70,30,29,11,70,0
11414,2022-11,86,31,41,14,81,5
11414,2022-12,102,31,55,16,100,2
11414,2023-01,107,48,47,12,107,0
11414,2023-02,80,24,39,17,78,2
11414,2023-03,89,34,48,7,88,1
11414,2023-04,87,32,43,12,85,2
11414,2023-05,117,33,65,19,116,1
11414,2023-06,90,32,39,19,88,2
11414,2023-07,82,37,39,6,82,0
11414,2023-08,102,55,36,11,100,2
11414,2023-09,76,29,36,11,75,1
11414,2023-10,99,30,50,19,96,3
11414,2023-11,71,34,26,11,68,3
11414,2023-12,101,43,39,19,101,0
11414,2024-01,95,41,42,12,94,1
11414,2024-02,83,32,37,14,81,2
11414,2024-03,82,30,38,14,77,5
11414,2024-04,108,35,58,15,106,2
11414,2024-05,95,43,44,8,92,3
11414,2024-06,109,42,48,19,108,1
11414,2024-07,103,33,47,23,101,2
11414,2024-08,113,47,46,20,112,1
11414,2024-09,96,38,41,17,96,0
11414,2024-10,121,38,62,21,119,2
11414,2024-11,82,26,42,14,82,0
11414,2024-12,98,31,57,10,95,3
11415,2020-01,48,10,25,13,47,1
11415,2020-02,33,12,15,6,33,0
11415,2020-03,36,13,18,5,35,1
11415,2020-04,37,13,22,2,37,0
11415,2020-05,37,12,21,4,37,0
11415,2020-06,38,8,24,6,38,0
11415,2020-07,24,5,18,1,22,2
11415,2020-08,42,18,17,7,42,0
11415,2020-09,38,12,20,6,38,0
11415,2020-10,41,13,20,8,39,2
11415,2020-11,45,20,18,7,45,0
11415,2020-12,33,7,18,8,33,0
11415,2021-01,36,15,17,4,36,0
11415,2021-02,41,15,23,3,41,0
11415,2021-03,27,3,16,8,26,1
11415,2021-04,41,10,21,10,41,0
11415,2021-05,38,12,17,9,38,0
11415,2021-06,59,18,31,10,59,0
11415,2021-07,29,7,12,10,29,0
11415,2021-08,50,18,28,4,50,0
11415,2021-09,33,9,18,6,33,0
11415,2021-10,56,15,31,10,55,1
11415,2021-11,42,21,17,4,42,0
11415,2021-12,44,16,22,6,44,0
11415,2022-01,52,14,28,10,52,0
11415,2022-02,39,15,17,7,37,2
11415,2022-03,31,6,20,5,31,0
11415,2022-04,51,16,20,15,51,0
11415,2022-05,59,24,28,7,59,0
11415,2022-06,51,8,34,9,51,0
11415,2022-07,56,19,29,8,56,0
11415,2022-08,52,14,26,12,51,1
11415,2022-09,46,15,27,4,46,0
11415,2022-10,64,17,34,13,63,1
11415,2022-11,47,18,23,6,46,1
11415,2022-12,47,16,22,9,47,0
11415,2023-01,49,22,23,4,49,0
11415,2023-02,47,18,18,11,47,0
11415,2023-03,56,16,31,9,56,0
11415,2023-04,54,21,26,7,52,2
11415,2023-05,63,25,26,12,63,0
11415,2023-06,55,14,34,7,55,0
11415,2023-07,54,28,23,3,54,0
11415,2023-08,55,17,30,8,54,1
11415,2023-09,65,22,34,9,64,1
11415,2023-10,58,15,25,18,58,0
11415,2023-11,69,32,27,10,67,2
11415,2023-12,56,17,28,11,54,2
11415,2024-01,67,21,28,18,67,0
11415,2024-02,56,20,23,13,56,0
11415,2024-03,52,14,30,8,52,0
11415,2024-04,51,11,29,11,50,1
11415,2024-05,48,13,27,8,46,2
11415,2024-06,56,21,22,13,56,0
11415,2024-07,53,19,24,10,53,0
11415,2024-08,49,23,17,9,47,2
11415,2024-09,65,15,36,14,65,0
11415,2024-10,63,25,27,11,63,0
11415,2024-11,52,20,22,10,50,2
11415,2024-12,42,8,25,9,41,1
11416,2020-01,89,23,43,23,87,2
11416,2020-02,54,24,23,7,53,1
11416,2020-03,71,19,38,14,71,0
11416,2020-04,57,16,28,13,57,0
11416,2020-05,84,31,40,13,83,1
11416,2020-06,69,23,31,15,68,1
11416,2020-07,80,25,31,24,78,2
11416,2020-08,65,21,29,15,64,1
11416,2020-09,70,31,23,16,69,1
11416,2020-10,83,30,34,19,81,2
11416,2020-11,66,22,31,13,65,1
11416,2020-12,70,21,35,14,69,1
11416,2021-01,50,16,25,9,50,0
11416,2021-02,64,24,27,13,64,0
11416,2021-03,76,16,39,21,75,0
11416,2021-04,57,17,24,16,57,0
11416,2021-05,95,31,40,24,94,1
11416,2021-06,79,25,31,23,78,1
11416,2021-07,95,35,46,14,92,3
11416,2021-08,89,28,38,23,89,0
11416,2021-09,86,35,41,10,85,1
11416,2021-10,94,21,48,25,93,1
11416,2021-11,93,26,52,15,93,0
11416,2021-12,88,35,36,17,86,2
11416,2022-01,88,29,35,24,87,1
11416,2022-02,73,22,40,11,72,1
11416,2022-03,109,31,48,30,108,1
11416,2022-04,90,20,49,21,89,1
11416,2022-05,108,41,48,19,107,1
11416,2022-06,109,29,53,27,106,3
11416,2022-07,90,25,46,19,89,1
11416,2022-08,111,42,44,25,108,3
11416,2022-09,91,35,46,10,90,1
11416,2022-10,108,36,45,27,106,2
11416,2022-11,106,35,49,22,105,1
11416,2022-12,108,45,48,15,104,4
11416,2023-01,92,34,47,11,92,0
11416,2023-02,75,23,38,14,75,0
11416,2023-03,89,32,41,16,89,0
11416,2023-04,101,37,48,16,101,0
11416,2023-05,108,36,51,21,107,1
11416,2023-06,81,27,38,16,79,2
11416,2023-07,98,33,37,28,96,2
11416,2023-08,85,32,34,19,84,1
11416,2023-09,80,26,28,26,77,3
11416,2023-10,84,31,25,28,82,2
11416,2023-11,104,37,42,25,103,1
11416,2023-12,76,25,34,17,76,0
11416,2024-01,90,33,42,15,89,1
11416,2024-02,78,19,40,19,77,1
11416,2024-03,67,20,34,13,66,1
11416,2024-04,105,34,48,23,105,0
11416,2024-05,99,32,42,25,99,0
11416,2024-06,97,22,43,32,95,2
11416,2024-07,86,23,44,19,86,0
11416,2024-08,76,25,35,16,76,0
11416,2024-09,79,24,35,20,79,0
11416,2024-10,84,27,29,28,82,2
11416,2024-11,49,20,21,8,48,1
11416,2024-12,58,15,29,14,57,1
11417,2020-01,155,63,72,20,153,2
11417,2020-02,113,39,52,22,110,3
11417,2020-03,119,42,60,17,118,1
11417,2020-04,74,30,30,14,71,3
11417,2020-05,92,32,45,15,89,3
11417,2020-06,118,49,53,16,115,3
11417,2020-07,137,54,66,17,136,1
11417,2020-08,110,38,57,15,107,3
11417,2020-09,104,40,48,16,104,0
11417,2020-10,127,50,52,25,125,2
11417,2020-11,104,43,48,13,101,3
11417,2020-12,102,35,51,16,101,1
11417,2021-01,102,44,44,14,102,0
11417,2021-02,98,34,47,17,98,0
11417,2021-03,109,40,54,15,109,0
11417,2021-04,107,43,47,17,106,1
11417,2021-05,139,46,74,19,138,1
11417,2021-06,101,27,62,12,99,2
11417,2021-07,135,56,64,15,134,1
11417,2021-08,124,46,61,17,123,1
11417,2021-09,162,48,81,33,161,1
11417,2021-10,161,60,75,26,157,4
11417,2021-11,121,36,65,20,120,1
11417,2021-12,131,62,52,17,128,3
11417,2022-01,135,56,55,24,133,2
11417,2022-02,140,64,67,9,137,3
11417,2022-03,136,41,74,21,136,0
11417,2022-04,126,39,65,22,126,0
11417,2022-05,158,47,84,27,157,1
11417,2022-06,162,61,73,28,157,5
11417,2022-07,166,57,82,27,165,1
11417,2022-08,141,51,59,31,139,2
11417,2022-09,137,36,73,28,134,3
11417,2022-10,136,51,66,19,133,3
11417,2022-11,132,41,76,15,131,1
11417,2022-12,135,54,56,25,134,1
11417,2023-01,167,52,93,22,167,0
11417,2023-02,122,34,67,21,122,0
11417,2023-03,159,43,96,20,158,1
11417,2023-04,166,50,95,21,165,1
11417,2023-05,157,39,88,30,155,2
11417,2023-06,149,48,82,19,149,0
11417,2023-07,174,62,90,22,172,2
11417,2023-08,146,50,72,24,145,1
11417,2023-09,155,54,68,33,153,2
11417,2023-10,176,60,98,18,174,2
11417,2023-11,166,43,99,24,165,1
11417,2023-12,126,40,74,12,125,1
11417,2024-01,146,54,70,22,145,1
11417,2024-02,120,42,60,18,118,2
11417,2024-03,167,44,104,19,167,0
11417,2024-04,163,41,95,27,162,1
11417,2024-05,137,39,78,20,134,3
11417,2024-06,190,44,117,29,189,1
11417,2024-07,148,51,83,14,147,1
11417,2024-08,173,52,102,19,169,4
11417,2024-09,157,48,88,21,155,2
11417,2024-10,166,45,96,25,166,0
11417,2024-11,146,33,92,21,145,1
11417,2024-12,128,46,73,9,126,2
11418,2020-01,128,35,65,28,127,1
11418,2020-02,161,45,91,25,158,3
11418,2020-03,148,35,89,24,147,1
11418,2020-04,115,38,57,20,115,0
11418,2020-05,132,33,77,22,131,1
11418,2020-06,105,35,53,17,104,1
11418,2020-07,125,32,69,24,124,1
11418,2020-08,128,40,68,20,126,2
11418,2020-09,137,38,77,22,136,1
11418,2020-10,131,33,80,18,131,0
11418,2020-11,129,38,67,24,124,5
11418,2020-12,140,43,80,17,140,0
11418,2021-01,151,33,93,25,148,3
11418,2021-02,97,31,49,17,95,2
11418,2021-03,134,25,78,31,134,0
11418,2021-04,146,36,76,34,145,1
11418,2021-05,144,41,78,25,144,0
11418,2021-06,153,51,71,31,153,0
11418,2021-07,156,53,82,21,155,1
11418,2021-08,168,52,85,31,166,2
11418,2021-09,175,47,102,26,174,1
11418,2021-10,177,55,88,34,176,1
11418,2021-11,181,58,97,26,179,2
11418,2021-12,181,55,99,27,178,3
11418,2022-01,152,41,84,27,152,0
11418,2022-02,155,49,76,30,151,4
11418,2022-03,155,47,84,24,154,1
11418,2022-04,166,42,95,29,164,2
11418,2022-05,186,64,101,21,184,2
11418,2022-06,205,59,104,42,202,3
11418,2022-07,213,67,123,23,211,2
11418,2022-08,160,44,92,24,157,3
11418,2022-09,196,71,99,26,195,1
11418,2022-10,198,68,105,25,198,0
11418,2022-11,161,46,83,32,157,4
11418,2022-12,180,63,93,24,180,0
11418,2023-01,149,54,79,16,148,1
11418,2023-02,161,36,108,17,159,2
11418,2023-03,185,58,104,23,183,2
11418,2023-04,181,54,101,26,179,2
11418,2023-05,192,52,122,18,191,1
11418,2023-06,185,54,94,37,183,2
11418,2023-07,164,57,79,28,158,6
11418,2023-08,173,61,90,22,171,2
11418,2023-09,152,54,75,23,150,2
11418,2023-10,172,63,87,22,171,1
11418,2023-11,171,51,86,34,168,3
11418,2023-12,186,64,95,27,179,7
11418,2024-01,205,60,122,23,203,2
11418,2024-02,189,59,107,23,187,2
11418,2024-03,177,53,94,30,174,3
11418,2024-04,202,70,104,28,200,2
11418,2024-05,175,51,89,35,172,3
11418,2024-06,168,39,96,33,165,3
11418,2024-07,192,61,100,31,188,4
11418,2024-08,168,51,86,31,168,0
11418,2024-09,159,47,84,28,158,1
11418,2024-10,209,55,114,40,208,1
11418,2024-11,161,47,94,20,158,3
11418,2024-12,136,41,70,25,136,0
11419,2020-01,173,69,76,28,170,3
11419,2020-02,152,52,79,21,150,2
11419,2020-03,143,61,62,20,143,0
11419,2020-04,127,43,59,25,124,3
11419,2020-05,117,39,54,24,115,2
11419,2020-06,136,41,61,34,135,1
11419,2020-07,195,74,84,37,190,5
11419,2020-08,161,63,65,33,160,1
11419,2020-09,145,57,62,26,145,0
11419,2020-10,177,57,84,36,174,3
11419,2020-11,197,74,85,38,196,1
11419,2020-12,152,55,61,36,152,0
11419,2021-01,134,48,64,22,133,1
11419,2021-02,117,35,55,27,115,2
11419,2021-03,174,58,89,27,171,2
11419,2021-04,148,57,68,23,143,5
11419,2021-05,183,53,91,39,182,1
11419,2021-06,213,69,94,50,212,1
11419,2021-07,193,60,82,51,191,2
11419,2021-08,213,77,103,33,213,0
11419,2021-09,220,71,88,61,219,1
11419,2021-10,219,77,104,38,214,5
11419,2021-11,198,84,74,40,192,6
11419,2021-12,206,88,90,28,202,4
11419,2022-01,170,65,75,30,170,0
11419,2022-02,178,68,75,35,175,3
11419,2022-03,223,70,123,30,221,2
11419,2022-04,218,67,115,36,215,3
11419,2022-05,250,60,145,45,245,5
11419,2022-06,258,94,121,43,258,0
11419,2022-07,238,79,127,32,232,6
11419,2022-08,285,79,160,46,283,2
11419,2022-09,276,102,132,42,274,2
11419,2022-10,247,87,122,38,246,1
11419,2022-11,228,70,118,40,228,0
11419,2022-12,204,72,93,39,203,1
11419,2023-01,214,65,111,38,212,2
11419,2023-02,175,58,100,17,175,0
11419,2023-03,208,67,112,29,206,2
11419,2023-04,173,58,71,44,169,4
11419,2023-05,271,82,137,52,268,3
11419,2023-06,214,69,102,43,211,3
11419,2023-07,224,77,107,40,218,6
11419,2023-08,217,78,88,51,216,1
11419,2023-09,213,73,100,40,212,1
11419,2023-10,246,79,119,48,246,0
11419,2023-11,220,66,108,46,217,3
11419,2023-12,217,84,92,41,214,3
11419,2024-01,181,52,94,35,178,3
11419,2024-02,189,59,95,35,188,1
11419,2024-03,217,60,122,35,212,5
11419,2024-04,199,70,92,37,193,6
11419,2024-05,234,73,118,43,232,2
11419,2024-06,280,88,124,68,280,0
11419,2024-07,264,86,124,54,260,4
11419,2024-08,255,70,139,46,252,3
11419,2024-09,238,66,126,46,237,1
11419,2024-10,254,66,133,55,249,5
11419,2024-11,229,62,127,40,226,3
11419,2024-12,201,59,98,44,199,2
11420,2020-01,184,62,92,30,181,3
11420,2020-02,223,84,110,29,222,1
11420,2020-03,157,62,73,22,155,2
11420,2020-04,114,36,58,20,112,2
11420,2020-05,139,44,71,24,139,0
11420,2020-06,154,48,73,33,154,0
11420,2020-07,177,65,72,40,175,2
11420,2020-08,187,80,76,31,185,2
11420,2020-09,219,83,95,41,212,7
11420,2020-10,151,53,71,27,151,0
11420,2020-11,185,67,89,29,184,1
11420,2020-12,152,69,66,17,149,3
11420,2021-01,165,59,79,27,163,2
11420,2021-02,143,54,60,29,142,1
11420,2021-03,160,50,78,32,157,3
11420,2021-04,165,59,79,27,163,2
11420,2021-05,183,61,88,34,181,2
11420,2021-06,186,72,80,34,182,4
11420,2021-07,206,79,76,51,203,3
11420,2021-08,243,98,94,51,241,2
11420,2021-09,219,72,97,50,216,3
11420,2021-10,197,76,87,34,194,3
11420,2021-11,234,98,106,30,231,3
11420,2021-12,254,92,119,43,251,3
11420,2022-01,193,62,101,30,191,2
11420,2022-02,205,98,85,22,202,3
11420,2022-03,197,67,106,24,191,6
11420,2022-04,217,72,106,39,215,2
11420,2022-05,212,66,115,31,207,5
11420,2022-06,240,71,115,54,235,5
11420,2022-07,212,80,90,42,207,5
11420,2022-08,223,67,116,40,219,4
11420,2022-09,207,75,108,24,201,6
11420,2022-10,199,81,77,41,190,9
11420,2022-11,173,62,73,38,172,1
11420,2022-12,206,69,105,32,204,2
11420,2023-01,223,86,94,43,223,0
11420,2023-02,225,80,109,36,222,3
11420,2023-03,190,69,104,17,189,1
11420,2023-04,189,66,86,37,185,4
11420,2023-05,195,61,89,45,195,0
11420,2023-06,225,98,92,35,223,2
11420,2023-07,243,79,126,38,240,3
11420,2023-08,218,72,115,31,217,1
11420,2023-09,199,82,87,30,197,2
11420,2023-10,219,75,112,32,219,0
11420,2023-11,190,56,99,35,187,3
11420,2023-12,195,71,92,32,193,2
11420,2024-01,191,68,94,29,188,3
11420,2024-02,170,63,83,24,168,2
11420,2024-03,197,62,94,41,194,3
11420,2024-04,183,76,85,22,182,1
11420,2024-05,242,100,106,36,239,3
11420,2024-06,219,62,111,46,218,1
11420,2024-07,237,78,110,49,236,1
11420,2024-08,222,72,106,44,221,1
11420,2024-09,239,82,116,41,234,5
11420,2024-10,234,71,129,34,232,2
11420,2024-11,222,70,120,32,221,1
11420,2024-12,160,52,86,22,157,3
11421,2020-01,123,31,72,20,122,1
11421,2020-02,110,27,71,12,108,2
11421,2020-03,100,30,51,19,99,1
11421,2020-04,79,27,42,10,78,1
11421,2020-05,94,30,45,19,94,0
11421,2020-06,126,35,67,24,126,0
11421,2020-07,134,37,74,23,133,1
11421,2020-08,107,32,59,16,105,2
11421,2020-09,84,22,37,25,83,1
11421,2020-10,131,40,68,23,131,0
11421,2020-11,79,16,49,14,79,0
11421,2020-12,94,32,46,16,93,1
11421,2021-01,122,23,75,24,121,1
11421,2021-02,100,27,67,6,97,3
11421,2021-03,102,26,45,31,100,1
11421,2021-04,96,28,46,22,96,0
11421,2021-05,132,34,68,30,132,0
11421,2021-06,118,35,60,23,116,2
11421,2021-07,142,45,76,21,141,1
11421,2021-08,131,33,70,28,131,0
11421,2021-09,134,40,61,33,131,3
11421,2021-10,120,34,63,23,118,2
11421,2021-11,132,35,65,32,130,2
11421,2021-12,147,40,75,32,143,4
11421,2022-01,137,44,71,22,134,3
11421,2022-02,121,38,72,11,119,2
11421,2022-03,140,32,83,25,140,0
11421,2022-04,144,38,74,32,140,4
11421,2022-05,161,46,94,21,155,6
11421,2022-06,141,37,83,21,138,3
11421,2022-07,156,43,79,34,155,1
11421,2022-08,165,45,96,24,162,3
11421,2022-09,149,43,81,25,148,1
11421,2022-10,143,36,80,27,143,0
11421,2022-11,162,42,95,25,162,0
11421,2022-12,133,40,73,20,133,0
11421,2023-01,149,51,77,21,147,2
11421,2023-02,131,38,65,28,129,2
11421,2023-03,166,43,100,23,165,1
11421,2023-04,157,53,81,23,157,0
11421,2023-05,201,68,102,31,200,1
11421,2023-06,141,39,82,20,140,1
11421,2023-07,151,48,68,35,150,1
11421,2023-08,160,53,75,32,157,3
11421,2023-09,152,57,73,22,149,3
11421,2023-10,144,54,69,21,141,3
11421,2023-11,154,49,84,21,150,4
11421,2023-12,141,39,77,25,140,1
11421,2024-01,131,41,65,25,129,2
11421,2024-02,136,46,64,26,133,3
11421,2024-03,154,41,89,24,152,2
11421,2024-04,171,44,95,32,171,0
11421,2024-05,143,36,75,32,141,2
11421,2024-06,128,32,74,22,128,0
11421,2024-07,168,45,93,30,166,2
11421,2024-08,158,40,88,30,157,1
11421,2024-09,132,45,62,25,130,2
11421,2024-10,149,40,66,43,147,2
11421,2024-11,121,24,75,22,120,1
11421,2024-12,120,37,57,26,119,1
11422,2020-01,92,41,33,18,91,1
11422,2020-02,100,34,47,19,99,1
11422,2020-03,79,25,34,20,79,0
11422,2020-04,67,25,27,15,66,1
11422,2020-05,104,39,43,22,101,3
11422,2020-06,93,30,42,21,91,2
11422,2020-07,105,36,48,21,104,1
11422,2020-08,108,32,43,33,106,2
11422,2020-09,88,35,30,23,83,5
11422,2020-10,109,36,52,21,107,2
11422,2020-11,101,35,40,26,99,2
11422,2020-12,88,33,34,21,87,1
11422,2021-01,100,32,47,21,100,0
11422,2021-02,64,17,29,18,64,0
11422,2021-03,83,24,39,20,83,0
11422,2021-04,80,25,29,26,77,3
11422,2021-05,83,28,29,26,83,0
11422,2021-06,84,35,28,21,82,2
11422,2021-07,97,27,36,34,95,2
11422,2021-08,97,32,38,27,93,4
11422,2021-09,112,35,49,28,110,2
11422,2021-10,99,23,47,29,98,1
11422,2021-11,110,37,53,20,109,1
11422,2021-12,114,34,59,21,112,2
11422,2022-01,68,22,34,12,68,0
11422,2022-02,80,30,38,12,80,0
11422,2022-03,123,35,62,26,123,0
11422,2022-04,120,21,73,26,117,3
11422,2022-05,134,44,58,32,133,1
11422,2022-06,121,31,69,21,121,0
11422,2022-07,132,47,58,27,132,0
11422,2022-08,126,35,63,28,122,4
11422,2022-09,108,35,44,29,107,1
11422,2022-10,116,33,54,29,114,2
11422,2022-11,136,40,73,23,135,1
11422,2022-12,102,28,49,25,102,0
11422,2023-01,87,29,37,21,87,0
11422,2023-02,93,27,41,25,92,1
11422,2023-03,126,34,64,28,124,2
11422,2023-04,115,42,46,27,114,1
11422,2023-05,129,47,48,34,129,0
11422,2023-06,138,39,67,32,137,1
11422,2023-07,157,50,76,31,155,2
11422,2023-08,137,51,65,21,134,3
11422,2023-09,120,35,62,23,120,0
11422,2023-10,114,33,58,23,113,1
11422,2023-11,114,37,51,26,113,1
11422,2023-12,106,35,40,31,106,0
11422,2024-01,119,44,43,32,117,2
11422,2024-02,113,34,59,20,111,2
11422,2024-03,100,33,49,18,99,1
11422,2024-04,102,32,48,22,102,0
11422,2024-05,111,32,53,26,110,1
11422,2024-06,114,35,47,32,113,1
11422,2024-07,144,46,54,44,144,0
11422,2024-08,90,42,33,15,90,0
11422,2024-09,119,43,48,28,117,2
11422,2024-10,95,41,35,19,93,2
11422,2024-11,105,35,50,20,100,5
11422,2024-12,109,29,63,17,108,1
11423,2020-01,82,28,43,11,81,1
11423,2020-02,69,27,30,12,68,1
11423,2020-03,68,28,32,8,68,0
11423,2020-04,62,20,29,13,60,2
11423,2020-05,87,33,42,12,87,0
11423,2020-06,82,25,45,12,81,1
11423,2020-07,99,29,50,20,98,1
11423,2020-08,102,39,41,22,100,2
11423,2020-09,89,30,51,8,89,0
11423,2020-10,97,34,43,20,96,1
11423,2020-11,86,31,31,24,85,1
11423,2020-12,105,31,58,16,104,1
11423,2021-01,83,32,36,15,83,0
11423,2021-02,83,26,44,13,83,0
11423,2021-03,82,21,43,18,81,1
11423,2021-04,73,27,27,19,73,0
11423,2021-05,89,21,48,20,86,3
11423,2021-06,99,35,48,16,97,2
11423,2021-07,106,24,58,24,102,4
11423,2021-08,125,39,66,20,123,2
11423,2021-09,94,27,47,20,91,3
11423,2021-10,121,56,47,18,118,3
11423,2021-11,90,36,40,14,88,2
11423,2021-12,111,46,52,13,111,0
11423,2022-01,112,44,55,13,109,3
11423,2022-02,89,36,38,15,89,0
11423,2022-03,133,56,49,28,128,5
11423,2022-04,111,39,59,13,110,1
11423,2022-05,120,50,58,12,117,3
11423,2022-06,137,48,63,26,135,2
11423,2022-07,142,57,61,24,141,1
11423,2022-08,138,48,66,24,137,1
11423,2022-09,116,46,49,21,115,1
11423,2022-10,128,60,51,17,125,3
11423,2022-11,123,63,44,16,123,0
11423,2022-12,119,47,57,15,119,0
11423,2023-01,115,46,50,19,111,4
11423,2023-02,100,33,51,16,96,4
11423,2023-03,136,64,54,18,135,1
11423,2023-04,147,71,61,15,146,1
11423,2023-05,109,44,48,17,109,0
11423,2023-06,120,38,60,22,117,3
11423,2023-07,127,47,58,22,124,3
11423,2023-08,127,41,61,25,125,2
11423,2023-09,119,47,44,28,117,2
11423,2023-10,117,58,51,8,115,2
11423,2023-11,129,41,69,19,128,1
11423,2023-12,142,52,70,20,142,0
11423,2024-01,134,39,71,24,131,3
11423,2024-02,92,34,40,18,92,0
11423,2024-03,109,43,48,18,102,7
11423,2024-04,128,51,54,23,126,2
11423,2024-05,124,51,51,22,124,0
11423,2024-06,130,45,71,14,128,2
11423,2024-07,140,52,68,20,140,0
11423,2024-08,141,46,70,25,139,2
11423,2024-09,132,54,56,22,130,2
11423,2024-10,113,52,44,17,112,1
11423,2024-11,112,44,55,13,110,2
11423,2024-12,121,49,52,20,119,2
11426,2020-01,41,19,15,7,41,0
11426,2020-02,42,18,16,8,42,0
11426,2020-03,29,14,10,5,29,0
11426,2020-04,22,10,8,4,22,0
11426,2020-05,33,9,16,8,33,0
11426,2020-06,42,10,17,15,42,0
11426,2020-07,55,20,18,17,55,0
11426,2020-08,47,7,33,7,46,1
11426,2020-09,34,8,18,8,33,1
11426,2020-10,47,16,25,6,47,0
11426,2020-11,46,10,23,13,46,0
11426,2020-12,42,13,20,9,42,0
11426,2021-01,41,10,24,7,40,1
11426,2021-02,36,10,16,10,36,0
11426,2021-03,31,7,15,9,31,0
11426,2021-04,33,14,14,5,32,1
11426,2021-05,24,8,10,6,24,0
11426,2021-06,43,18,18,7,43,0
11426,2021-07,45,10,21,14,45,0
11426,2021-08,40,8,23,9,40,0
11426,2021-09,49,16,21,12,49,0
11426,2021-10,51,20,22,9,51,0
11426,2021-11,57,18,29,10,56,1
11426,2021-12,64,21,34,9,62,2
11426,2022-01,31,11,15,5,31,0
11426,2022-02,42,15,20,7,41,1
11426,2022-03,26,8,12,6,25,1
11426,2022-04,47,14,21,12,47,0
11426,2022-05,33,10,14,9,33,0
11426,2022-06,64,15,29,20,63,1
11426,2022-07,48,20,22,6,48,0
11426,2022-08,62,17,32,13,62,0
11426,2022-09,46,22,15,9,45,1
11426,2022-10,47,19,17,11,46,1
11426,2022-11,45,16,23,6,44,1
11426,2022-12,43,15,17,11,43,0
11426,2023-01,31,13,12,6,30,1
11426,2023-02,38,18,13,7,37,1
11426,2023-03,47,14,28,5,47,0
11426,2023-04,34,12,14,8,34,0
11426,2023-05,50,18,25,7,49,1
11426,2023-06,53,24,21,8,52,1
11426,2023-07,40,10,22,8,40,0
11426,2023-08,42,14,21,7,41,1
11426,2023-09,58,22,27,9,57,1
11426,2023-10,31,17,10,4,30,1
11426,2023-11,43,20,13,10,43,0
11426,2023-12,51,22,24,5,51,0
11426,2024-01,43,13,20,10,42,1
11426,2024-02,45,14,20,11,45,0
11426,2024-03,51,22,17,12,51,0
11426,2024-04,51,22,18,11,51,0
11426,2024-05,50,17,23,10,50,0
11426,2024-06,72,23,35,14,72,0
11426,2024-07,44,15,25,4,44,0
11426,2024-08,46,18,17,11,46,0
11426,2024-09,41,19,18,4,40,1
11426,2024-10,75,30,32,13,74,1
11426,2024-11,44,22,12,10,44,0
11426,2024-12,22,10,7,5,22,0
11427,2020-01,60,23,27,10,59,1
11427,2020-02,41,8,21,12,41,0
11427,2020-03,56,27,20,9,54,2
11427,2020-04,46,16,25,5,45,1
11427,2020-05,55,18,25,12,52,3
11427,2020-06,63,13,42,8,63,0
11427,2020-07,40,11,18,11,40,0
11427,2020-08,54,17,25,12,53,1
11427,2020-09,47,19,19,9,46,1
11427,2020-10,51,15,23,13,50,1
11427,2020-11,55,18,30,7,53,2
11427,2020-12,63,23,27,13,59,4
11427,2021-01,54,13,30,11,54,0
11427,2021-02,38,9,20,9,37,1
11427,2021-03,62,22,29,11,61,1
11427,2021-04,47,15,25,7,46,1
11427,2021-05,52,14,30,8,52,0
11427,2021-06,52,16,22,14,52,0
11427,2021-07,75,31,30,14,73,2
11427,2021-08,80,26,37,17,79,1
11427,2021-09,82,30,41,11,81,1
11427,2021-10,77,18,47,12,77,0
11427,2021-11,78,30,36,12,77,1
11427,2021-12,76,23,43,10,73,3
11427,2022-01,78,18,42,18,74,4
11427,2022-02,56,20,26,10,54,2
11427,2022-03,66,22,32,12,65,1
11427,2022-04,87,20,49,18,84,3
11427,2022-05,93,30,48,15,91,2
11427,2022-06,117,35,62,20,115,2
11427,2022-07,73,31,31,11,72,1
11427,2022-08,61,24,22,15,59,2
11427,2022-09,88,33,42,13,87,1
11427,2022-10,60,17,31,12,59,1
11427,2022-11,101,35,52,14,101,0
11427,2022-12,86,26,39,21,84,2
11427,2023-01,55,14,29,12,55,0
11427,2023-02,63,26,27,10,62,1
11427,2023-03,81,37,39,5,79,2
11427,2023-04,71,24,37,10,71,0
11427,2023-05,97,33,44,20,95,2
11427,2023-06,70,22,35,13,69,1
11427,2023-07,72,35,21,16,71,1
11427,2023-08,98,39,44,15,97,1
11427,2023-09,85,34,36,15,83,2
11427,2023-10,85,29,43,13,85,0
11427,2023-11,77,24,30,23,77,0
11427,2023-12,86,29,44,13,85,1
11427,2024-01,92,30,38,24,91,1
11427,2024-02,64,20,32,12,62,2
11427,2024-03,80,30,40,10,78,2
11427,2024-04,57,20,27,10,57,0
11427,2024-05,75,30,34,11,74,1
11427,2024-06,63,13,39,11,62,1
11427,2024-07,61,21,26,14,60,1
11427,2024-08,92,37,34,21,91,1
11427,2024-09,62,25,26,11,62,0
11427,2024-10,92,34,43,15,90,2
11427,2024-11,72,29,25,18,70,2
11427,2024-12,79,25,38,16,78,1
11428,2020-01,88,34,32,22,87,1
11428,2020-02,61,30,19,12,59,2
11428,2020-03,63,20,29,14,63,0
11428,2020-04,58,25,25,8,57,1
11428,2020-05,73,21,37,15,71,2
11428,2020-06,72,24,32,16,72,0
11428,2020-07,76,27,29,20,74,2
11428,2020-08,79,28,37,14,77,2
11428,2020-09,62,25,23,14,58,4
11428,2020-10,63,26,31,6,62,1
11428,2020-11,73,29,30,14,72,1
11428,2020-12,58,20,27,11,57,1
11428,2021-01,81,28,43,10,80,1
11428,2021-02,56,21,25,10,55,1
11428,2021-03,61,21,33,7,60,1
11428,2021-04,63,20,34,9,61,2
11428,2021-05,77,28,36,13,76,1
11428,2021-06,56,17,24,15,52,4
11428,2021-07,77,32,25,20,75,2
11428,2021-08,61,17,32,12,59,2
11428,2021-09,71,25,33,13,68,3
11428,2021-10,82,23,45,14,77,5
11428,2021-11,88,27,49,12,87,1
11428,2021-12,99,23,52,24,98,1
11428,2022-01,84,26,41,17,82,2
11428,2022-02,82,26,42,14,81,1
11428,2022-03,103,35,48,20,101,2
11428,2022-04,66,22,36,8,64,2
11428,2022-05,105,34,54,17,103,2
11428,2022-06,99,32,49,18,97,2
11428,2022-07,101,40,49,12,98,3
11428,2022-08,91,29,48,14,89,2
11428,2022-09,74,17,46,11,74,0
11428,2022-10,122,37,59,26,121,1
11428,2022-11,96,25,59,12,95,1
11428,2022-12,103,36,54,13,100,3
11428,2023-01,117,31,62,24,116,1
11428,2023-02,109,35,55,19,108,1
11428,2023-03,103,33,57,13,100,3
11428,2023-04,104,22,60,22,102,2
11428,2023-05,100,29,54,17,100,0
11428,2023-06,120,28,71,21,118,2
11428,2023-07,107,33,51,23,105,2
11428,2023-08,109,29,59,21,104,5
11428,2023-09,122,33,65,24,122,0
11428,2023-10,105,25,53,27,104,1
11428,2023-11,103,25,60,18,101,2
11428,2023-12,104,27,52,25,104,0
11428,2024-01,118,38,62,18,115,3
11428,2024-02,110,32,56,22,108,2
11428,2024-03,87,26,46,15,87,0
11428,2024-04,101,23,59,19,98,3
11428,2024-05,94,25,52,17,93,1
11428,2024-06,105,21,69,15,105,0
11428,2024-07,98,24,59,15,98,0
11428,2024-08,111,34,58,19,109,2
11428,2024-09,82,23,47,12,82,0
11428,2024-10,87,28,43,16,86,1
11428,2024-11,113,30,60,23,112,1
11428,2024-12,86,14,55,17,85,1
11429,2020-01,109,36,46,27,106,3
11429,2020-02,93,28,50,15,91,2
11429,2020-03,102,41,45,16,100,2
11429,2020-04,78,24,36,18,76,2
11429,2020-05,103,38,42,23,103,0
11429,2020-06,95,28,48,19,91,4
11429,2020-07,103,36,44,23,103,0
11429,2020-08,113,44,47,22,112,1
11429,2020-09,102,34,47,21,102,0
11429,2020-10,90,36,34,20,88,2
11429,2020-11,108,51,41,16,100,8
11429,2020-12,93,34,44,15,92,1
11429,2021-01,93,28,46,19,91,2
11429,2021-02,93,26,43,24,92,1
11429,2021-03,93,25,51,17,92,1
11429,2021-04,83,28,35,20,81,2
11429,2021-05,97,36,46,15,93,4
11429,2021-06,97,22,50,25,96,1
11429,2021-07,98,26,50,22,98,0
11429,2021-08,103,29,46,28,102,1
11429,2021-09,89,24,46,19,87,2
11429,2021-10,100,26,48,26,99,1
11429,2021-11,104,41,39,24,99,5
11429,2021-12,99,32,50,17,94,5
11429,2022-01,98,30,56,12,98,0
11429,2022-02,99,34,46,19,97,2
11429,2022-03,126,43,64,19,125,1
11429,2022-04,91,25,43,23,90,1
11429,2022-05,111,31,55,25,107,4
11429,2022-06,116,32,61,23,114,2
11429,2022-07,133,39,61,33,131,2
11429,2022-08,108,37,52,19,105,3
11429,2022-09,120,35,59,26,119,1
11429,2022-10,112,31,54,27,112,0
11429,2022-11,115,33,54,28,115,0
11429,2022-12,94,22,48,24,93,1
11429,2023-01,118,40,60,18,118,0
11429,2023-02,111,26,60,25,109,2
11429,2023-03,121,28,78,15,121,0
11429,2023-04,118,37,60,21,117,1
11429,2023-05,140,41,66,33,137,3
11429,2023-06,132,38,68,26,131,1
11429,2023-07,140,44,72,24,139,1
11429,2023-08,153,57,78,18,152,1
11429,2023-09,102,48,42,12,99,3
11429,2023-10,121,39,58,24,118,3
11429,2023-11,111,28,63,20,110,1
11429,2023-12,155,41,82,32,154,1
11429,2024-01,94,43,35,16,94,0
11429,2024-02,90,29,45,16,90,0
11429,2024-03,99,33,47,19,99,0
11429,2024-04,122,42,55,25,121,1
11429,2024-05,146,46,77,23,144,2
11429,2024-06,110,42,48,20,109,1
11429,2024-07,125,40,48,37,124,1
11429,2024-08,106,36,39,31,103,3
11429,2024-09,105,47,35,23,104,1
11429,2024-10,107,48,33,26,106,1
11429,2024-11,106,38,48,20,105,1
11429,2024-12,100,32,47,21,99,1
11432,2020-01,313,122,155,36,303,10
11432,2020-02,258,92,142,24,255,3
11432,2020-03,221,80,120,21,215,6
11432,2020-04,183,70,92,21,178,5
11432,2020-05,253,95,130,28,246,7
11432,2020-06,246,69,143,34,243,3
11432,2020-07,275,96,141,38,272,3
11432,2020-08,285,110,127,48,282,3
11432,2020-09,281,96,146,39,273,8
11432,2020-10,289,109,140,40,287,2
11432,2020-11,275,78,168,29,274,1
11432,2020-12,246,80,131,35,243,3
11432,2021-01,231,78,126,27,229,2
11432,2021-02,174,54,94,26,172,2
11432,2021-03,203,52,119,32,202,1
11432,2021-04,224,65,131,28,222,2
11432,2021-05,247,93,120,34,243,4
11432,2021-06,272,91,149,32,270,2
11432,2021-07,291,85,177,29,288,3
11432,2021-08,288,90,167,31,283,5
11432,2021-09,375,118,201,56,370,5
11432,2021-10,336,135,162,39,331,5
11432,2021-11,343,128,178,37,336,7
11432,2021-12,336,120,169,47,333,3
11432,2022-01,321,128,163,30,315,6
11432,2022-02,315,110,173,32,314,1
11432,2022-03,319,105,177,37,314,5
11432,2022-04,328,114,177,37,321,7
11432,2022-05,373,126,202,45,370,3
11432,2022-06,363,114,201,48,360,3
11432,2022-07,381,129,211,41,378,3
11432,2022-08,410,137,229,44,400,10
11432,2022-09,421,157,231,33,414,7
11432,2022-10,422,148,229,45,417,5
11432,2022-11,350,104,213,33,349,1
11432,2022-12,321,116,176,29,317,4
11432,2023-01,388,125,230,33,386,2
11432,2023-02,335,93,210,32,333,2
11432,2023-03,381,107,216,58,375,6
11432,2023-04,371,119,218,34,363,8
11432,2023-05,413,118,256,39,407,6
11432,2023-06,414,123,237,54,405,9
11432,2023-07,428,154,230,44,423,5
11432,2023-08,405,136,209,60,403,2
11432,2023-09,450,156,238,56,448,2
11432,2023-10,521,166,285,70,513,8
11432,2023-11,437,122,260,55,432,5
11432,2023-12,423,121,259,43,415,8
11432,2024-01,457,141,264,52,449,8
11432,2024-02,431,111,268,52,427,4
11432,2024-03,469,159,263,47,464,5
11432,2024-04,467,159,260,48,464,3
11432,2024-05,498,140,295,63,494,4
11432,2024-06,579,169,340,70,571,8
11432,2024-07,510,141,318,51,503,7
11432,2024-08,515,145,307,63,511,4
11432,2024-09,517,127,315,75,513,4
11432,2024-10,499,146,288,65,492,7
11432,2024-11,448,129,252,67,443,5
11432,2024-12,389,105,237,47,382,7
11433,2020-01,208,60,110,38,205,3
11433,2020-02,230,74,127,29,229,1
11433,2020-03,182,59,95,28,179,3
11433,2020-04,168,62,84,22,166,2
11433,2020-05,215,78,115,22,211,4
11433,2020-06,183,62,93,28,179,4
11433,2020-07,221,74,109,38,220,1
11433,2020-08,250,93,114,43,248,2
11433,2020-09,219,84,100,35,216,3
11433,2020-10,220,76,102,42,217,3
11433,2020-11,229,69,145,15,228,1
11433,2020-12,213,75,113,25,209,4
11433,2021-01,193,73,102,18,190,3
11433,2021-02,193,58,108,27,190,3
11433,2021-03,206,66,110,30,202,4
11433,2021-04,184,57,102,25,182,2
11433,2021-05,185,64,99,22,183,2
11433,2021-06,221,81,107,33,218,3
11433,2021-07,259,93,134,32,255,4
11433,2021-08,222,90,100,32,220,2
11433,2021-09,227,79,117,31,222,5
11433,2021-10,226,71,119,36,223,3
11433,2021-11,215,72,102,41,214,1
11433,2021-12,254,92,126,36,252,2
11433,2022-01,251,89,126,36,246,5
11433,2022-02,222,89,110,23,221,1
11433,2022-03,256,90,135,31,252,4
11433,2022-04,246,89,133,24,245,1
11433,2022-05,259,86,135,38,256,3
11433,2022-06,257,77,137,43,256,1
11433,2022-07,260,98,131,31,257,3
11433,2022-08,268,93,132,43,265,3
11433,2022-09,249,90,122,37,247,2
11433,2022-10,259,74,142,43,255,4
11433,2022-11,251,82,132,37,250,1
11433,2022-12,251,65,149,37,248,3
11433,2023-01,259,82,144,33,258,1
11433,2023-02,264,93,146,25,262,2
11433,2023-03,321,104,185,32,318,3
11433,2023-04,298,93,170,35,295,3
11433,2023-05,327,106,176,45,325,2
11433,2023-06,297,108,152,37,295,2
11433,2023-07,355,114,195,46,351,4
11433,2023-08,315,100,173,42,313,2
11433,2023-09,337,122,168,47,331,6
11433,2023-10,308,98,167,43,304,4
11433,2023-11,320,95,193,32,316,4
11433,2023-12,324,101,185,38,320,4
11433,2024-01,313,110,171,32,307,6
11433,2024-02,276,91,159,26,270,6
11433,2024-03,299,108,153,38,294,5
11433,2024-04,315,105,162,48,312,3
11433,2024-05,336,128,176,32,330,6
11433,2024-06,332,113,186,33,327,5
11433,2024-07,340,122,178,40,338,2
11433,2024-08,368,141,179,48,362,6
11433,2024-09,336,114,172,50,334,2
11433,2024-10,351,107,198,46,346,5
11433,2024-11,305,95,172,38,301,4
11433,2024-12,257,78,146,33,256,1
11434,2020-01,381,137,179,65,377,4
11434,2020-02,344,102,176,66,341,3
11434,2020-03,313,114,148,51,311,2
11434,2020-04,312,100,165,47,311,1
11434,2020-05,336,114,175,47,333,3
11434,2020-06,349,129,160,60,343,6
11434,2020-07,379,120,176,83,375,4
11434,2020-08,405,138,175,92,401,4
11434,2020-09,374,148,156,70,365,9
11434,2020-10,340,107,153,80,338,2
11434,2020-11,313,125,128,60,310,3
11434,2020-12,312,105,166,41,304,8
11434,2021-01,345,118,166,61,339,6
11434,2021-02,293,81,152,60,291,2
11434,2021-03,375,133,204,38,374,1
11434,2021-04,345,124,164,57,343,2
11434,2021-05,419,140,187,92,410,9
11434,2021-06,397,140,191,66,394,3
11434,2021-07,389,134,189,66,385,4
11434,2021-08,327,106,170,51,324,3
11434,2021-09,368,119,187,62,365,3
11434,2021-10,388,127,199,62,384,4
11434,2021-11,389,132,191,66,386,3
11434,2021-12,375,141,171,63,369,6
11434,2022-01,380,137,187,56,375,5
11434,2022-02,339,121,184,34,337,2
11434,2022-03,386,135,198,53,383,3
11434,2022-04,384,140,177,67,381,3
11434,2022-05,403,134,207,62,395,8
11434,2022-06,416,134,214,68,412,4
11434,2022-07,463,142,258,63,459,4
11434,2022-08,474,153,254,67,468,6
11434,2022-09,424,124,242,58,419,5
11434,2022-10,421,107,257,57,417,4
11434,2022-11,400,108,234,58,394,6
11434,2022-12,367,115,210,42,365,2
11434,2023-01,414,111,249,54,408,6
11434,2023-02,390,115,219,56,389,1
11434,2023-03,437,128,251,58,434,3
11434,2023-04,471,118,289,64,468,3
11434,2023-05,452,124,264,64,449,3
11434,2023-06,479,142,279,58,473,6
11434,2023-07,484,130,283,71,474,10
11434,2023-08,452,128,272,52,444,8
11434,2023-09,398,124,215,59,395,3
11434,2023-10,472,129,279,64,468,4
11434,2023-11,489,130,286,73,483,6
11434,2023-12,390,121,215,54,383,7
11434,2024-01,459,128,276,55,452,7
11434,2024-02,462,136,266,60,459,3
11434,2024-03,469,142,264,63,464,5
11434,2024-04,485,142,286,57,475,10
11434,2024-05,478,132,287,59,473,5
11434,2024-06,438,126,258,54,434,4
11434,2024-07,515,152,268,95,510,5
11434,2024-08,476,139,264,73,474,2
11434,2024-09,448,121,237,90,441,7
11434,2024-10,437,118,246,73,429,8
11434,2024-11,418,107,232,79,415,3
11434,2024-12,429,128,239,62,426,3
11435,2020-01,210,88,99,23,206,4
11435,2020-02,185,67,88,30,182,3
11435,2020-03,170,48,104,18,167,3
11435,2020-04,138,60,60,18,134,4
11435,2020-05,205,85,94,26,195,10
11435,2020-06,206,75,99,32,203,3
11435,2020-07,235,88,107,40,231,4
11435,2020-08,270,110,114,46,263,7
11435,2020-09,220,78,119,23,214,6
11435,2020-10,239,94,122,23,238,1
11435,2020-11,228,81,121,26,226,2
11435,2020-12,247,96,118,33,244,3
11435,2021-01,240,84,120,36,235,5
11435,2021-02,183,64,86,33,183,0
11435,2021-03,203,88,87,28,202,1
11435,2021-04,189,62,92,35,187,2
11435,2021-05,209,87,92,30,208,1
11435,2021-06,222,93,96,33,220,2
11435,2021-07,243,105,113,25,241,2
11435,2021-08,254,123,99,32,244,10
11435,2021-09,251,105,106,40,249,2
11435,2021-10,242,102,109,31,236,6
11435,2021-11,208,79,103,26,207,1
11435,2021-12,250,120,97,33,244,6
11435,2022-01,234,103,98,33,232,2
11435,2022-02,198,72,105,21,192,6
11435,2022-03,238,92,111,35,235,3
11435,2022-04,268,102,123,43,266,2
11435,2022-05,323,119,162,42,318,5
11435,2022-06,350,151,164,35,343,7
11435,2022-07,327,133,153,41,325,2
11435,2022-08,324,142,142,40,319,5
11435,2022-09,296,130,136,30,293,3
11435,2022-10,376,151,195,30,372,4
11435,2022-11,299,100,155,44,297,2
11435,2022-12,329,123,161,45,323,6
11435,2023-01,319,113,182,24,315,4
11435,2023-02,318,116,168,34,313,5
11435,2023-03,354,132,180,42,351,3
11435,2023-04,358,127,189,42,352,6
11435,2023-05,404,146,217,41,400,4
11435,2023-06,353,117,200,36,349,4
11435,2023-07,386,134,197,55,383,3
11435,2023-08,414,159,199,56,412,2
11435,2023-09,421,149,225,47,418,3
11435,2023-10,440,159,231,50,438,2
11435,2023-11,352,128,172,52,351,1
11435,2023-12,338,92,204,42,335,3
11435,2024-01,418,129,236,53,412,6
11435,2024-02,381,131,202,48,377,4
11435,2024-03,455,144,253,58,454,1
11435,2024-04,374,113,204,57,368,6
11435,2024-05,429,143,226,60,424,5
11435,2024-06,475,153,260,62,471,4
11435,2024-07,518,152,302,64,511,7
11435,2024-08,435,131,244,60,432,3
11435,2024-09,427,141,238,48,422,5
11435,2024-10,390,125,215,50,385,5
11435,2024-11,417,117,238,62,408,9
11435,2024-12,412,122,223,67,409,3
11436,2020-01,71,28,29,14,71,0
11436,2020-02,55,12,28,15,55,0
11436,2020-03,57,21,24,12,57,0
11436,2020-04,76,26,41,9,73,3
11436,2020-05,80,28,39,13,79,1
11436,2020-06,89,30,42,17,88,1
11436,2020-07,100,17,52,31,100,0
11436,2020-08,93,33,38,22,93,0
11436,2020-09,70,28,27,15,70,0
11436,2020-10,79,27,34,18,78,1
11436,2020-11,76,25,37,14,74,2
11436,2020-12,77,28,33,16,77,0
11436,2021-01,73,27,36,10,73,0
11436,2021-02,78,30,34,14,77,1
11436,2021-03,81,18,46,17,81,0
11436,2021-04,69,21,22,26,68,1
11436,2021-05,83,29,30,24,83,0
11436,2021-06,115,30,54,31,115,0
11436,2021-07,102,36,43,23,102,0
11436,2021-08,91,34,39,18,91,0
11436,2021-09,79,25,31,23,79,0
11436,2021-10,76,29,27,20,73,3
11436,2021-11,88,44,28,16,88,0
11436,2021-12,81,32,30,19,79,2
11436,2022-01,64,17,23,24,64,0
11436,2022-02,72,32,27,13,72,0
11436,2022-03,66,20,26,20,65,1
11436,2022-04,76,22,39,15,76,0
11436,2022-05,92,26,47,19,92,0
11436,2022-06,104,42,42,20,102,2
11436,2022-07,115,40,45,30,114,1
11436,2022-08,99,33,45,21,99,0
11436,2022-09,66,22,25,19,65,1
11436,2022-10,77,17,42,18,75,2
11436,2022-11,61,21,29,11,61,0
11436,2022-12,89,34,40,15,87,2
11436,2023-01,87,27,39,21,87,0
11436,2023-02,91,26,48,17,91,0
11436,2023-03,96,26,50,20,96,0
11436,2023-04,96,37,50,9,96,0
11436,2023-05,102,38,43,21,101,1
11436,2023-06,111,37,59,15,111,0
11436,2023-07,115,31,62,22,115,0
11436,2023-08,116,35,58,23,116,0
11436,2023-09,77,23,34,20,77,0
11436,2023-10,84,29,38,17,84,0
11436,2023-11,99,41,49,9,99,0
11436,2023-12,93,28,54,11,92,1
11436,2024-01,88,34,44,10,85,3
11436,2024-02,102,27,62,13,98,4
11436,2024-03,114,31,62,21,113,1
11436,2024-04,82,23,46,13,82,0
11436,2024-05,102,25,63,14,101,1
11436,2024-06,106,22,66,18,105,1
11436,2024-07,96,25,47,24,94,2
11436,2024-08,99,16,63,20,96,3
11436,2024-09,96,17,56,23,96,0
11436,2024-10,86,19,42,25,85,1
11436,2024-11,100,24,57,19,98,2
11436,2024-12,82,26,48,8,82,0
11691,2020-01,356,105,185,66,354,2
11691,2020-02,333,113,162,58,330,3
11691,2020-03,306,90,148,68,302,4
11691,2020-04,232,80,107,45,226,6
11691,2020-05,323,74,173,76,319,4
11691,2020-06,361,112,185,64,354,7
11691,2020-07,320,90,149,81,316,4
11691,2020-08,321,94,137,90,314,7
11691,2020-09,326,108,146,72,323,3
11691,2020-10,308,110,139,59,305,3
11691,2020-11,354,102,167,85,353,1
11691,2020-12,323,97,150,76,320,3
11691,2021-01,270,91,124,55,268,2
11691,2021-02,267,86,129,52,266,1
11691,2021-03,319,86,139,94,312,6
11691,2021-04,327,93,148,86,323,4
11691,2021-05,337,99,162,76,334,3
11691,2021-06,349,104,165,80,344,5
11691,2021-07,342,111,167,64,337,5
11691,2021-08,343,123,148,72,338,5
11691,2021-09,382,125,163,94,378,4
11691,2021-10,332,88,153,91,327,5
11691,2021-11,255,64,131,60,254,1
11691,2021-12,301,111,119,71,295,6
11691,2022-01,275,85,122,68,272,3
11691,2022-02,260,84,116,60,257,3
11691,2022-03,292,112,113,67,290,2
11691,2022-04,303,97,132,74,299,4
11691,2022-05,346,90,172,84,341,5
11691,2022-06,353,100,168,85,350,3
11691,2022-07,347,110,149,88,345,2
11691,2022-08,323,96,150,77,320,3
11691,2022-09,336,93,178,65,335,1
11691,2022-10,312,92,144,76,307,5
11691,2022-11,318,93,136,89,313,5
11691,2022-12,253,62,127,64,252,1
11691,2023-01,290,73,148,69,289,1
11691,2023-02,292,91,127,74,290,2
11691,2023-03,322,88,145,89,315,7
11691,2023-04,349,99,157,93,344,5
11691,2023-05,348,106,158,84,340,8
11691,2023-06,324,103,143,78,321,3
11691,2023-07,346,107,165,74,341,5
11691,2023-08,350,108,159,83,345,5
11691,2023-09,366,114,171,81,361,5
11691,2023-10,347,101,155,91,340,7
11691,2023-11,272,71,125,76,271,1
11691,2023-12,295,85,139,71,288,7
11691,2024-01,353,98,181,74,349,4
11691,2024-02,308,89,156,63,307,1
11691,2024-03,315,99,138,78,313,2
11691,2024-04,338,90,160,88,335,3
11691,2024-05,330,91,157,82,326,4
11691,2024-06,384,102,185,97,381,3
11691,2024-07,418,117,211,90,418,0
11691,2024-08,459,143,214,102,452,7
11691,2024-09,421,127,198,96,415,6
11691,2024-10,419,123,201,95,413,6
11691,2024-11,396,106,189,101,393,3
11691,2024-12,376,107,172,97,371,5
11692,2020-01,103,31,52,20,102,1
11692,2020-02,120,43,58,19,119,1
11692,2020-03,150,52,73,25,149,1
11692,2020-04,116,45,55,16,115,1
11692,2020-05,132,51,63,18,129,3
11692,2020-06,133,52,59,22,127,6
11692,2020-07,142,44,71,27,136,6
11692,2020-08,98,35,40,23,95,3
11692,2020-09,105,41,35,29,101,4
11692,2020-10,110,34,47,29,110,0
11692,2020-11,99,34,41,24,99,0
11692,2020-12,95,32,47,16,95,0
11692,2021-01,98,29,47,22,98,0
11692,2021-02,99,29,44,26,98,1
11692,2021-03,106,38,42,26,104,2
11692,2021-04,103,32,55,16,102,1
11692,2021-05,101,24,50,27,100,1
11692,2021-06,102,28,50,24,100,2
11692,2021-07,116,36,57,23,112,4
11692,2021-08,116,36,56,24,116,0
11692,2021-09,97,22,47,28,96,1
11692,2021-10,120,32,62,26,120,0
11692,2021-11,88,27,34,27,87,1
11692,2021-12,99,27,44,28,98,1
11692,2022-01,86,32,37,17,83,3
11692,2022-02,83,26,33,24,78,5
11692,2022-03,79,26,33,20,78,1
11692,2022-04,93,31,44,18,91,2
11692,2022-05,116,37,54,25,112,4
11692,2022-06,137,35,64,38,135,2
11692,2022-07,176,63,73,40,175,1
11692,2022-08,118,39,48,31,118,0
11692,2022-09,86,18,46,22,85,1
11692,2022-10,107,29,54,24,106,1
11692,2022-11,107,29,48,30,107,0
11692,2022-12,101,25,54,22,100,1
11692,2023-01,113,36,46,31,111,2
11692,2023-02,99,25,46,28,98,1
11692,2023-03,108,36,47,25,107,1
11692,2023-04,95,31,39,25,95,0
11692,2023-05,102,32,39,31,100,2
11692,2023-06,111,43,41,27,109,2
11692,2023-07,129,36,63,30,126,3
11692,2023-08,107,38,42,27,105,2
11692,2023-09,89,33,43,13,89,0
11692,2023-10,105,33,45,27,103,2
11692,2023-11,121,31,67,23,121,0
11692,2023-12,126,42,63,21,123,3
11692,2024-01,131,40,62,29,131,0
11692,2024-02,97,35,38,24,94,3
11692,2024-03,136,40,67,29,131,5
11692,2024-04,136,28,66,42,134,2
11692,2024-05,101,34,47,20,98,3
11692,2024-06,125,38,58,29,124,1
11692,2024-07,120,32,56,32,119,1
11692,2024-08,113,29,50,34,108,5
11692,2024-09,116,37,54,25,115,1
11692,2024-10,112,30,45,37,112,0
11692,2024-11,112,31,48,33,110,2
11692,2024-12,95,20,53,22,95,0
11693,2020-01,68,17,38,13,65,3
11693,2020-02,80,20,45,15,78,2
11693,2020-03,67,13,36,18,66,1
11693,2020-04,61,17,34,10,61,0
11693,2020-05,80,25,40,15,78,2
11693,2020-06,71,22,34,15,70,1
11693,2020-07,90,30,44,16,88,2
11693,2020-08,103,32,55,16,99,4
11693,2020-09,75,32,30,13,72,3
11693,2020-10,84,23,41,20,80,4
11693,2020-11,70,21,33,16,66,4
11693,2020-12,52,9,28,15,52,0
11693,2021-01,76,27,30,19,72,4
11693,2021-02,58,16,32,10,57,1
11693,2021-03,72,17,39,16,71,1
11693,2021-04,63,24,23,16,61,2
11693,2021-05,58,18,31,9,58,0
11693,2021-06,80,23,45,12,78,2
11693,2021-07,94,37,38,19,92,2
11693,2021-08,89,30,41,18,87,2
11693,2021-09,78,21,41,16,77,1
11693,2021-10,68,24,33,11,67,1
11693,2021-11,49,22,15,12,49,0
11693,2021-12,76,21,42,13,76,0
11693,2022-01,65,17,29,19,64,1
11693,2022-02,51,17,27,7,51,0
11693,2022-03,59,12,33,14,59,0
11693,2022-04,73,28,33,12,71,2
11693,2022-05,93,22,49,22,91,2
11693,2022-06,91,31,45,15,89,2
11693,2022-07,98,30,53,15,96,2
11693,2022-08,118,37,48,33,117,1
11693,2022-09,92,31,42,19,92,0
11693,2022-10,85,36,38,11,84,1
11693,2022-11,91,26,52,13,91,0
11693,2022-12,76,21,46,9,74,2
11693,2023-01,76,23,36,17,75,1
11693,2023-02,46,9,24,13,45,1
11693,2023-03,63,16,39,8,59,4
11693,2023-04,73,21,36,16,72,1
11693,2023-05,74,20,37,17,73,1
11693,2023-06,81,27,37,17,77,4
11693,2023-07,119,35,64,20,117,2
11693,2023-08,84,31,45,8,79,5
11693,2023-09,81,33,34,14,81,0
11693,2023-10,67,22,30,15,65,2
11693,2023-11,66,26,31,9,64,2
11693,2023-12,78,22,41,15,75,3
11693,2024-01,73,19,39,15,70,3
11693,2024-02,79,31,31,17,73,6
11693,2024-03,65,22,27,16,65,0
11693,2024-04,90,31,39,20,88,2
11693,2024-05,101,39,47,15,100,1
11693,2024-06,111,35,56,20,107,4
11693,2024-07,88,26,46,16,87,1
11693,2024-08,98,26,57,15,95,3
11693,2024-09,108,31,48,29,107,1
11693,2024-10,66,19,31,16,65,1
11693,2024-11,61,19,23,19,61,0
11693,2024-12,57,14,32,11,56,1
11694,2020-01,64,19,32,13,60,4
11694,2020-02,66,19,34,13,66,0
11694,2020-03,50,15,19,16,48,2
11694,2020-04,52,17,21,14,50,2
11694,2020-05,57,11,33,13,56,1
11694,2020-06,69,20,36,13,68,1
11694,2020-07,104,25,59,20,101,3
11694,2020-08,100,19,57,24,97,3
11694,2020-09,58,17,30,11,56,2
11694,2020-10,57,15,26,16,56,1
11694,2020-11,56,16,28,12,55,1
11694,2020-12,48,13,21,14,48,0
11694,2021-01,40,13,18,9,40,0
11694,2021-02,42,12,21,9,42,0
11694,2021-03,53,18,28,7,53,0
11694,2021-04,41,11,19,11,41,0
11694,2021-05,70,19,39,12,70,0
11694,2021-06,59,11,32,16,57,2
11694,2021-07,79,16,38,25,77,2
11694,2021-08,71,19,34,18,71,0
11694,2021-09,63,13,38,12,62,1
11694,2021-10,74,7,46,21,74,0
11694,2021-11,61,18,27,16,61,0
11694,2021-12,66,24,29,13,65,1
11694,2022-01,60,17,28,15,60,0
11694,2022-02,94,12,62,20,94,0
11694,2022-03,98,22,55,21,96,2
11694,2022-04,113,30,62,21,109,4
11694,2022-05,83,25,42,16,80,3
11694,2022-06,111,23,67,21,109,2
11694,2022-07,95,23,53,19,94,1
11694,2022-08,81,28,33,20,81,0
11694,2022-09,96,25,55,16,93,3
11694,2022-10,91,27,49,15,89,2
11694,2022-11,75,17,46,12,74,1
11694,2022-12,60,20,26,14,59,1
11694,2023-01,90,22,52,16,90,0
11694,2023-02,63,13,36,14,63,0
11694,2023-03,80,17,52,11,79,1
11694,2023-04,78,18,50,10,75,3
11694,2023-05,75,18,35,22,75,0
11694,2023-06,125,42,56,27,124,1
11694,2023-07,116,31,64,21,115,1
11694,2023-08,87,17,46,24,87,0
11694,2023-09,71,21,34,16,68,3
11694,2023-10,87,27,48,12,85,2
11694,2023-11,58,15,36,7,58,0
11694,2023-12,64,22,32,10,61,3
11694,2024-01,75,18,41,16,74,1
11694,2024-02,79,21,44,14,78,1
11694,2024-03,104,20,60,24,103,1
11694,2024-04,52,10,28,14,50,2
11694,2024-05,71,22,35,14,71,0
11694,2024-06,92,22,51,19,91,1
11694,2024-07,97,22,56,19,96,1
11694,2024-08,98,30,54,14,93,5
11694,2024-09,98,18,63,17,96,2
11694,2024-10,76,12,48,16,76,0
11694,2024-11,70,18,40,12,70,0
11694,2024-12,64,17,37,10,64,0
11697,2020-01,4,3,0,1,3,1
11697,2020-02,3,1,1,1,3,0
11697,2020-03,7,3,1,3,6,1
11697,2020-04,2,1,1,0,2,0
11697,2020-05,3,2,1,0,3,0
11697,2020-06,1,0,1,0,1,0
11697,2020-07,6,4,2,0,6,0
11697,2020-08,3,2,1,0,3,0
11697,2020-09,4,1,2,1,4,0
11697,2020-10,16,3,11,2,13,3
11697,2020-11,5,2,3,0,5,0
11697,2020-12,5,4,1,0,5,0
11697,2021-01,1,1,0,0,1,0
11697,2021-02,2,2,0,0,2,0
11697,2021-03,9,3,6,0,8,1
11697,2021-04,5,2,2,1,5,0
11697,2021-05,3,1,2,0,3,0
11697,2021-06,3,1,0,2,3,0
11697,2021-07,5,1,2,2,5,0
11697,2021-08,3,1,0,2,3,0
11697,2021-09,5,4,1,0,3,2
11697,2021-10,9,7,1,1,9,0
11697,2021-11,3,1,2,0,3,0
11697,2021-12,1,1,0,0,1,0
11697,2022-01,4,3,0,1,4,0
11697,2022-02,1,1,0,0,1,0
11697,2022-03,5,2,3,0,5,0
11697,2022-04,3,1,2,0,3,0
11697,2022-05,2,0,0,2,1,1
11697,2022-06,3,1,2,0,3,0
11697,2022-07,6,1,2,3,6,0
11697,2022-08,4,3,1,0,4,0
11697,2022-09,2,1,1,0,2,0
11697,2022-10,3,0,3,0,3,0
11697,2022-11,3,2,1,0,3,0
11697,2022-12,2,1,1,0,2,0
11697,2023-01,4,1,3,0,4,0
11697,2023-02,1,1,0,0,1,0
11697,2023-03,3,2,1,0,3,0
11697,2023-04,2,2,0,0,2,0
11697,2023-05,4,2,0,2,4,0
11697,2023-06,6,3,1,2,6,0
11697,2023-07,5,2,3,0,5,0
11697,2023-08,3,0,3,0,3,0
11697,2023-09,4,1,1,2,4,0
11697,2023-10,7,3,4,0,7,0
11697,2023-11,4,1,3,0,4,0
11697,2023-12,3,1,1,1,3,0
11697,2024-02,5,3,0,2,5,0
11697,2024-03,2,1,1,0,2,0
11697,2024-05,6,3,1,2,6,0
11697,2024-06,6,2,3,1,6,0
11697,2024-07,2,1,1,0,2,0
11697,2024-08,2,2,0,0,2,0
11697,2024-09,1,1,0,0,1,0
11697,2024-10,3,1,0,2,3,0
11697,2024-11,2,1,1,0,2,0
11697,2024-12,4,0,3,1,4,0
99999,2020-01,100,26,55,19,98,2
99999,2020-02,76,18,38,20,74,2
99999,2020-03,76,25,42,9,76,0
99999,2020-04,65,14,40,11,60,5
99999,2020-05,98,32,59,7,95,3
99999,2020-06,119,32,72,15,118,1
99999,2020-07,112,43,53,16,109,3
99999,2020-08,118,41,60,17,115,3
99999,2020-09,127,46,65,16,122,5
99999,2020-10,90,33,47,10,88,2
99999,2020-11,115,40,63,12,111,4
99999,2020-12,73,21,45,7,73,0
99999,2021-01,110,38,55,17,108,2
99999,2021-02,75,24,38,13,75,0
99999,2021-03,90,25,50,15,88,2
99999,2021-04,117,34,69,14,114,3
99999,2021-05,113,43,53,17,111,2
99999,2021-06,117,37,62,18,113,4
99999,2021-07,104,25,57,22,102,2
99999,2021-08,120,40,61,19,120,0
99999,2021-09,113,42,58,13,112,1
99999,2021-10,105,38,50,17,105,0
99999,2021-11,94,42,39,13,91,3
99999,2021-12,90,34,39,17,87,3
99999,2022-01,98,35,50,13,95,3
99999,2022-02,88,29,48,11,88,0
99999,2022-03,118,36,66,16,114,4
99999,2022-04,123,33,71,19,121,2
99999,2022-05,139,47,75,17,138,1
99999,2022-06,141,49,63,29,138,3
99999,2022-07,139,57,66,16,135,4
99999,2022-08,136,40,76,20,129,7
99999,2022-09,163,57,78,28,159,4
99999,2022-10,122,42,55,25,118,4
99999,2022-11,100,41,48,11,99,1
99999,2022-12,91,28,51,12,91,0
99999,2023-01,110,45,52,13,108,2
99999,2023-02,107,48,44,15,102,5
99999,2023-03,124,38,65,21,124,0
99999,2023-04,142,46,66,30,141,1
99999,2023-05,175,54,97,24,172,3
99999,2023-06,177,69,74,34,172,5
99999,2023-07,165,51,90,24,159,6
99999,2023-08,157,69,71,17,153,4
99999,2023-09,164,60,73,31,161,3
99999,2023-10,135,50,67,18,134,1
99999,2023-11,124,39,67,18,123,1
99999,2023-12,127,49,63,15,126,1
99999,2024-01,111,39,58,14,108,3
99999,2024-02,106,41,47,18,103,3
99999,2024-03,131,52,59,20,127,4
99999,2024-04,120,48,59,13,117,3
99999,2024-05,149,57,68,24,143,6
99999,2024-06,169,74,72,23,162,7
99999,2024-07,188,72,88,28,181,7
99999,2024-08,185,60,95,30,183,2
99999,2024-09,150,37,94,19,149,1
99999,2024-10,144,38,79,27,140,4
99999,2024-11,126,44,69,13,124,2
99999,2024-12,101,33,59,9,100,1
